kyeok	ㄱ
ssangkiyeok	ㄲ
kiyeok-sios	ㄳ
nieun	ㄴ
nieun-cieuc	ㄵ
nieun-hieuh	ㄶ
tikeut	ㄷ
ssangtikeut	ㄸ
rieul	ㄹ
rieul-kiyeok	ㄺ
rieul-mieum	ㄻ
rieul-pieup	ㄼ
rieul-sios	ㄽ
rieul-thieuth	ㄾ
rieul-phieuph	ㄿ
rieul-hieuh	ㅀ
mieum	ㅁ
pieup	ㅂ
ssangpieup	ㅃ
pieup-sios	ㅄ
sios	ㅅ
ssangsios	ㅆ
ieung	ㅇ
cieuc	ㅈ
ssangcieuc	ㅉ
chieuch	ㅊ
khieukh	ㅋ
thieuth	ㅌ
phieuph	ㅍ
ga	가
gag	각
gagg	갂
gags	갃
gan	간
ganj	갅
ganh	갆
gad	갇
gal	갈
galg	갉
galm	갊
galb	갋
gals	갌
galt	갍
galp	갎
galh	갏
gam	감
gab	갑
gabs	값
gas	갓
gass	갔
gang	강
gaj	갖
gac	갗
gak	갘
gat	같
gap	갚
gah	갛
gae	개
gaeg	객
gaegg	갞
gaegs	갟
gaen	갠
gaenj	갡
gaenh	갢
gaed	갣
gael	갤
gaelg	갥
gaelm	갦
gaelb	갧
gaels	갨
gaelt	갩
gaelp	갪
gaelh	갫
gaem	갬
gaeb	갭
gaebs	갮
gaes	갯
gaess	갰
gaeng	갱
gaej	갲
gaec	갳
gaek	갴
gaet	갵
gaep	갶
gaeh	갷
gya	갸
gyag	갹
gyagg	갺
gyags	갻
gyan	갼
gyanj	갽
gyanh	갾
gyad	갿
gyal	걀
gyalg	걁
gyalm	걂
gyalb	걃
gyals	걄
gyalt	걅
gyalp	걆
gyalh	걇
gyam	걈
gyab	걉
gyabs	걊
gyas	걋
gyass	걌
gyang	걍
gyaj	걎
gyac	걏
gyak	걐
gyat	걑
gyap	걒
gyah	걓
gyae	걔
gyaeg	걕
gyaegg	걖
gyaegs	걗
gyaen	걘
gyaenj	걙
gyaenh	걚
gyaed	걛
gyael	걜
gyaelg	걝
gyaelm	걞
gyaelb	걟
gyaels	걠
gyaelt	걡
gyaelp	걢
gyaelh	걣
gyaem	걤
gyaeb	걥
gyaebs	걦
gyaes	걧
gyaess	걨
gyaeng	걩
gyaej	걪
gyaec	걫
gyaek	걬
gyaet	걭
gyaep	걮
gyaeh	걯
geo	거
geog	걱
geogg	걲
geogs	걳
geon	건
geonj	걵
geonh	걶
geod	걷
geol	걸
geolg	걹
geolm	걺
geolb	걻
geols	걼
geolt	걽
geolp	걾
geolh	걿
geom	검
geob	겁
geobs	겂
geos	것
geoss	겄
geong	겅
geoj	겆
geoc	겇
geok	겈
geot	겉
geop	겊
geoh	겋
ge	게
geg	겍
gegg	겎
gegs	겏
gen	겐
genj	겑
genh	겒
ged	겓
gel	겔
gelg	겕
gelm	겖
gelb	겗
gels	겘
gelt	겙
gelp	겚
gelh	겛
gem	겜
geb	겝
gebs	겞
ges	겟
gess	겠
geng	겡
gej	겢
gec	겣
gek	겤
get	겥
gep	겦
geh	겧
gyeo	겨
gyeog	격
gyeogg	겪
gyeogs	겫
gyeon	견
gyeonj	겭
gyeonh	겮
gyeod	겯
gyeol	결
gyeolg	겱
gyeolm	겲
gyeolb	겳
gyeols	겴
gyeolt	겵
gyeolp	겶
gyeolh	겷
gyeom	겸
gyeob	겹
gyeobs	겺
gyeos	겻
gyeoss	겼
gyeong	경
gyeoj	겾
gyeoc	겿
gyeok	곀
gyeot	곁
gyeop	곂
gyeoh	곃
gye	계
gyeg	곅
gyegg	곆
gyegs	곇
gyen	곈
gyenj	곉
gyenh	곊
gyed	곋
gyel	곌
gyelg	곍
gyelm	곎
gyelb	곏
gyels	곐
gyelt	곑
gyelp	곒
gyelh	곓
gyem	곔
gyeb	곕
gyebs	곖
gyes	곗
gyess	곘
gyeng	곙
gyej	곚
gyec	곛
gyek	곜
gyet	곝
gyep	곞
gyeh	곟
go	고
gog	곡
gogg	곢
gogs	곣
gon	곤
gonj	곥
gonh	곦
god	곧
gol	골
golg	곩
golm	곪
golb	곫
gols	곬
golt	곭
golp	곮
golh	곯
gom	곰
gob	곱
gobs	곲
gos	곳
goss	곴
gong	공
goj	곶
goc	곷
gok	곸
got	곹
gop	곺
goh	곻
gwa	과
gwag	곽
gwagg	곾
gwags	곿
gwan	관
gwanj	괁
gwanh	괂
gwad	괃
gwal	괄
gwalg	괅
gwalm	괆
gwalb	괇
gwals	괈
gwalt	괉
gwalp	괊
gwalh	괋
gwam	괌
gwab	괍
gwabs	괎
gwas	괏
gwass	괐
gwang	광
gwaj	괒
gwac	괓
gwak	괔
gwat	괕
gwap	괖
gwah	괗
gwae	괘
gwaeg	괙
gwaegg	괚
gwaegs	괛
gwaen	괜
gwaenj	괝
gwaenh	괞
gwaed	괟
gwael	괠
gwaelg	괡
gwaelm	괢
gwaelb	괣
gwaels	괤
gwaelt	괥
gwaelp	괦
gwaelh	괧
gwaem	괨
gwaeb	괩
gwaebs	괪
gwaes	괫
gwaess	괬
gwaeng	괭
gwaej	괮
gwaec	괯
gwaek	괰
gwaet	괱
gwaep	괲
gwaeh	괳
goe	괴
goeg	괵
goegg	괶
goegs	괷
goen	괸
goenj	괹
goenh	괺
goed	괻
goel	괼
goelg	괽
goelm	괾
goelb	괿
goels	굀
goelt	굁
goelp	굂
goelh	굃
goem	굄
goeb	굅
goebs	굆
goes	굇
goess	굈
goeng	굉
goej	굊
goec	굋
goek	굌
goet	굍
goep	굎
goeh	굏
gyo	교
gyog	굑
gyogg	굒
gyogs	굓
gyon	굔
gyonj	굕
gyonh	굖
gyod	굗
gyol	굘
gyolg	굙
gyolm	굚
gyolb	굛
gyols	굜
gyolt	굝
gyolp	굞
gyolh	굟
gyom	굠
gyob	굡
gyobs	굢
gyos	굣
gyoss	굤
gyong	굥
gyoj	굦
gyoc	굧
gyok	굨
gyot	굩
gyop	굪
gyoh	굫
gu	구
gug	국
gugg	굮
gugs	굯
gun	군
gunj	굱
gunh	굲
gud	굳
gul	굴
gulg	굵
gulm	굶
gulb	굷
guls	굸
gult	굹
gulp	굺
gulh	굻
gum	굼
gub	굽
gubs	굾
gus	굿
guss	궀
gung	궁
guj	궂
guc	궃
guk	궄
gut	궅
gup	궆
guh	궇
gweo	궈
gweog	궉
gweogg	궊
gweogs	궋
gweon	권
gweonj	궍
gweonh	궎
gweod	궏
gweol	궐
gweolg	궑
gweolm	궒
gweolb	궓
gweols	궔
gweolt	궕
gweolp	궖
gweolh	궗
gweom	궘
gweob	궙
gweobs	궚
gweos	궛
gweoss	궜
gweong	궝
gweoj	궞
gweoc	궟
gweok	궠
gweot	궡
gweop	궢
gweoh	궣
gwe	궤
gweg	궥
gwegg	궦
gwegs	궧
gwen	궨
gwenj	궩
gwenh	궪
gwed	궫
gwel	궬
gwelg	궭
gwelm	궮
gwelb	궯
gwels	궰
gwelt	궱
gwelp	궲
gwelh	궳
gwem	궴
gweb	궵
gwebs	궶
gwes	궷
gwess	궸
gweng	궹
gwej	궺
gwec	궻
gwek	궼
gwet	궽
gwep	궾
gweh	궿
gwi	귀
gwig	귁
gwigg	귂
gwigs	귃
gwin	귄
gwinj	귅
gwinh	귆
gwid	귇
gwil	귈
gwilg	귉
gwilm	귊
gwilb	귋
gwils	귌
gwilt	귍
gwilp	귎
gwilh	귏
gwim	귐
gwib	귑
gwibs	귒
gwis	귓
gwiss	귔
gwing	귕
gwij	귖
gwic	귗
gwik	귘
gwit	귙
gwip	귚
gwih	귛
gyu	규
gyug	귝
gyugg	귞
gyugs	귟
gyun	균
gyunj	귡
gyunh	귢
gyud	귣
gyul	귤
gyulg	귥
gyulm	귦
gyulb	귧
gyuls	귨
gyult	귩
gyulp	귪
gyulh	귫
gyum	귬
gyub	귭
gyubs	귮
gyus	귯
gyuss	귰
gyung	귱
gyuj	귲
gyuc	귳
gyuk	귴
gyut	귵
gyup	귶
gyuh	귷
geu	그
geug	극
geugg	귺
geugs	귻
geun	근
geunj	귽
geunh	귾
geud	귿
geul	글
geulg	긁
geulm	긂
geulb	긃
geuls	긄
geult	긅
geulp	긆
geulh	긇
geum	금
geub	급
geubs	긊
geus	긋
geuss	긌
geung	긍
geuj	긎
geuc	긏
geuk	긐
geut	긑
geup	긒
geuh	긓
gyi	긔
gyig	긕
gyigg	긖
gyigs	긗
gyin	긘
gyinj	긙
gyinh	긚
gyid	긛
gyil	긜
gyilg	긝
gyilm	긞
gyilb	긟
gyils	긠
gyilt	긡
gyilp	긢
gyilh	긣
gyim	긤
gyib	긥
gyibs	긦
gyis	긧
gyiss	긨
gying	긩
gyij	긪
gyic	긫
gyik	긬
gyit	긭
gyip	긮
gyih	긯
gi	기
gig	긱
gigg	긲
gigs	긳
gin	긴
ginj	긵
ginh	긶
gid	긷
gil	길
gilg	긹
gilm	긺
gilb	긻
gils	긼
gilt	긽
gilp	긾
gilh	긿
gim	김
gib	깁
gibs	깂
gis	깃
giss	깄
ging	깅
gij	깆
gic	깇
gik	깈
git	깉
gip	깊
gih	깋
gga	까
ggag	깍
ggagg	깎
ggags	깏
ggan	깐
gganj	깑
gganh	깒
ggad	깓
ggal	깔
ggalg	깕
ggalm	깖
ggalb	깗
ggals	깘
ggalt	깙
ggalp	깚
ggalh	깛
ggam	깜
ggab	깝
ggabs	깞
ggas	깟
ggass	깠
ggang	깡
ggaj	깢
ggac	깣
ggak	깤
ggat	깥
ggap	깦
ggah	깧
ggae	깨
ggaeg	깩
ggaegg	깪
ggaegs	깫
ggaen	깬
ggaenj	깭
ggaenh	깮
ggaed	깯
ggael	깰
ggaelg	깱
ggaelm	깲
ggaelb	깳
ggaels	깴
ggaelt	깵
ggaelp	깶
ggaelh	깷
ggaem	깸
ggaeb	깹
ggaebs	깺
ggaes	깻
ggaess	깼
ggaeng	깽
ggaej	깾
ggaec	깿
ggaek	꺀
ggaet	꺁
ggaep	꺂
ggaeh	꺃
ggya	꺄
ggyag	꺅
ggyagg	꺆
ggyags	꺇
ggyan	꺈
ggyanj	꺉
ggyanh	꺊
ggyad	꺋
ggyal	꺌
ggyalg	꺍
ggyalm	꺎
ggyalb	꺏
ggyals	꺐
ggyalt	꺑
ggyalp	꺒
ggyalh	꺓
ggyam	꺔
ggyab	꺕
ggyabs	꺖
ggyas	꺗
ggyass	꺘
ggyang	꺙
ggyaj	꺚
ggyac	꺛
ggyak	꺜
ggyat	꺝
ggyap	꺞
ggyah	꺟
ggyae	꺠
ggyaeg	꺡
ggyaegg	꺢
ggyaegs	꺣
ggyaen	꺤
ggyaenj	꺥
ggyaenh	꺦
ggyaed	꺧
ggyael	꺨
ggyaelg	꺩
ggyaelm	꺪
ggyaelb	꺫
ggyaels	꺬
ggyaelt	꺭
ggyaelp	꺮
ggyaelh	꺯
ggyaem	꺰
ggyaeb	꺱
ggyaebs	꺲
ggyaes	꺳
ggyaess	꺴
ggyaeng	꺵
ggyaej	꺶
ggyaec	꺷
ggyaek	꺸
ggyaet	꺹
ggyaep	꺺
ggyaeh	꺻
ggeo	꺼
ggeog	꺽
ggeogg	꺾
ggeogs	꺿
ggeon	껀
ggeonj	껁
ggeonh	껂
ggeod	껃
ggeol	껄
ggeolg	껅
ggeolm	껆
ggeolb	껇
ggeols	껈
ggeolt	껉
ggeolp	껊
ggeolh	껋
ggeom	껌
ggeob	껍
ggeobs	껎
ggeos	껏
ggeoss	껐
ggeong	껑
ggeoj	껒
ggeoc	껓
ggeok	껔
ggeot	껕
ggeop	껖
ggeoh	껗
gge	께
ggeg	껙
ggegg	껚
ggegs	껛
ggen	껜
ggenj	껝
ggenh	껞
gged	껟
ggel	껠
ggelg	껡
ggelm	껢
ggelb	껣
ggels	껤
ggelt	껥
ggelp	껦
ggelh	껧
ggem	껨
ggeb	껩
ggebs	껪
gges	껫
ggess	껬
ggeng	껭
ggej	껮
ggec	껯
ggek	껰
gget	껱
ggep	껲
ggeh	껳
ggyeo	껴
ggyeog	껵
ggyeogg	껶
ggyeogs	껷
ggyeon	껸
ggyeonj	껹
ggyeonh	껺
ggyeod	껻
ggyeol	껼
ggyeolg	껽
ggyeolm	껾
ggyeolb	껿
ggyeols	꼀
ggyeolt	꼁
ggyeolp	꼂
ggyeolh	꼃
ggyeom	꼄
ggyeob	꼅
ggyeobs	꼆
ggyeos	꼇
ggyeoss	꼈
ggyeong	꼉
ggyeoj	꼊
ggyeoc	꼋
ggyeok	꼌
ggyeot	꼍
ggyeop	꼎
ggyeoh	꼏
ggye	꼐
ggyeg	꼑
ggyegg	꼒
ggyegs	꼓
ggyen	꼔
ggyenj	꼕
ggyenh	꼖
ggyed	꼗
ggyel	꼘
ggyelg	꼙
ggyelm	꼚
ggyelb	꼛
ggyels	꼜
ggyelt	꼝
ggyelp	꼞
ggyelh	꼟
ggyem	꼠
ggyeb	꼡
ggyebs	꼢
ggyes	꼣
ggyess	꼤
ggyeng	꼥
ggyej	꼦
ggyec	꼧
ggyek	꼨
ggyet	꼩
ggyep	꼪
ggyeh	꼫
ggo	꼬
ggog	꼭
ggogg	꼮
ggogs	꼯
ggon	꼰
ggonj	꼱
ggonh	꼲
ggod	꼳
ggol	꼴
ggolg	꼵
ggolm	꼶
ggolb	꼷
ggols	꼸
ggolt	꼹
ggolp	꼺
ggolh	꼻
ggom	꼼
ggob	꼽
ggobs	꼾
ggos	꼿
ggoss	꽀
ggong	꽁
ggoj	꽂
ggoc	꽃
ggok	꽄
ggot	꽅
ggop	꽆
ggoh	꽇
ggwa	꽈
ggwag	꽉
ggwagg	꽊
ggwags	꽋
ggwan	꽌
ggwanj	꽍
ggwanh	꽎
ggwad	꽏
ggwal	꽐
ggwalg	꽑
ggwalm	꽒
ggwalb	꽓
ggwals	꽔
ggwalt	꽕
ggwalp	꽖
ggwalh	꽗
ggwam	꽘
ggwab	꽙
ggwabs	꽚
ggwas	꽛
ggwass	꽜
ggwang	꽝
ggwaj	꽞
ggwac	꽟
ggwak	꽠
ggwat	꽡
ggwap	꽢
ggwah	꽣
ggwae	꽤
ggwaeg	꽥
ggwaegg	꽦
ggwaegs	꽧
ggwaen	꽨
ggwaenj	꽩
ggwaenh	꽪
ggwaed	꽫
ggwael	꽬
ggwaelg	꽭
ggwaelm	꽮
ggwaelb	꽯
ggwaels	꽰
ggwaelt	꽱
ggwaelp	꽲
ggwaelh	꽳
ggwaem	꽴
ggwaeb	꽵
ggwaebs	꽶
ggwaes	꽷
ggwaess	꽸
ggwaeng	꽹
ggwaej	꽺
ggwaec	꽻
ggwaek	꽼
ggwaet	꽽
ggwaep	꽾
ggwaeh	꽿
ggoe	꾀
ggoeg	꾁
ggoegg	꾂
ggoegs	꾃
ggoen	꾄
ggoenj	꾅
ggoenh	꾆
ggoed	꾇
ggoel	꾈
ggoelg	꾉
ggoelm	꾊
ggoelb	꾋
ggoels	꾌
ggoelt	꾍
ggoelp	꾎
ggoelh	꾏
ggoem	꾐
ggoeb	꾑
ggoebs	꾒
ggoes	꾓
ggoess	꾔
ggoeng	꾕
ggoej	꾖
ggoec	꾗
ggoek	꾘
ggoet	꾙
ggoep	꾚
ggoeh	꾛
ggyo	꾜
ggyog	꾝
ggyogg	꾞
ggyogs	꾟
ggyon	꾠
ggyonj	꾡
ggyonh	꾢
ggyod	꾣
ggyol	꾤
ggyolg	꾥
ggyolm	꾦
ggyolb	꾧
ggyols	꾨
ggyolt	꾩
ggyolp	꾪
ggyolh	꾫
ggyom	꾬
ggyob	꾭
ggyobs	꾮
ggyos	꾯
ggyoss	꾰
ggyong	꾱
ggyoj	꾲
ggyoc	꾳
ggyok	꾴
ggyot	꾵
ggyop	꾶
ggyoh	꾷
ggu	꾸
ggug	꾹
ggugg	꾺
ggugs	꾻
ggun	꾼
ggunj	꾽
ggunh	꾾
ggud	꾿
ggul	꿀
ggulg	꿁
ggulm	꿂
ggulb	꿃
gguls	꿄
ggult	꿅
ggulp	꿆
ggulh	꿇
ggum	꿈
ggub	꿉
ggubs	꿊
ggus	꿋
gguss	꿌
ggung	꿍
gguj	꿎
gguc	꿏
gguk	꿐
ggut	꿑
ggup	꿒
gguh	꿓
ggweo	꿔
ggweog	꿕
ggweogg	꿖
ggweogs	꿗
ggweon	꿘
ggweonj	꿙
ggweonh	꿚
ggweod	꿛
ggweol	꿜
ggweolg	꿝
ggweolm	꿞
ggweolb	꿟
ggweols	꿠
ggweolt	꿡
ggweolp	꿢
ggweolh	꿣
ggweom	꿤
ggweob	꿥
ggweobs	꿦
ggweos	꿧
ggweoss	꿨
ggweong	꿩
ggweoj	꿪
ggweoc	꿫
ggweok	꿬
ggweot	꿭
ggweop	꿮
ggweoh	꿯
ggwe	꿰
ggweg	꿱
ggwegg	꿲
ggwegs	꿳
ggwen	꿴
ggwenj	꿵
ggwenh	꿶
ggwed	꿷
ggwel	꿸
ggwelg	꿹
ggwelm	꿺
ggwelb	꿻
ggwels	꿼
ggwelt	꿽
ggwelp	꿾
ggwelh	꿿
ggwem	뀀
ggweb	뀁
ggwebs	뀂
ggwes	뀃
ggwess	뀄
ggweng	뀅
ggwej	뀆
ggwec	뀇
ggwek	뀈
ggwet	뀉
ggwep	뀊
ggweh	뀋
ggwi	뀌
ggwig	뀍
ggwigg	뀎
ggwigs	뀏
ggwin	뀐
ggwinj	뀑
ggwinh	뀒
ggwid	뀓
ggwil	뀔
ggwilg	뀕
ggwilm	뀖
ggwilb	뀗
ggwils	뀘
ggwilt	뀙
ggwilp	뀚
ggwilh	뀛
ggwim	뀜
ggwib	뀝
ggwibs	뀞
ggwis	뀟
ggwiss	뀠
ggwing	뀡
ggwij	뀢
ggwic	뀣
ggwik	뀤
ggwit	뀥
ggwip	뀦
ggwih	뀧
ggyu	뀨
ggyug	뀩
ggyugg	뀪
ggyugs	뀫
ggyun	뀬
ggyunj	뀭
ggyunh	뀮
ggyud	뀯
ggyul	뀰
ggyulg	뀱
ggyulm	뀲
ggyulb	뀳
ggyuls	뀴
ggyult	뀵
ggyulp	뀶
ggyulh	뀷
ggyum	뀸
ggyub	뀹
ggyubs	뀺
ggyus	뀻
ggyuss	뀼
ggyung	뀽
ggyuj	뀾
ggyuc	뀿
ggyuk	끀
ggyut	끁
ggyup	끂
ggyuh	끃
ggeu	끄
ggeug	끅
ggeugg	끆
ggeugs	끇
ggeun	끈
ggeunj	끉
ggeunh	끊
ggeud	끋
ggeul	끌
ggeulg	끍
ggeulm	끎
ggeulb	끏
ggeuls	끐
ggeult	끑
ggeulp	끒
ggeulh	끓
ggeum	끔
ggeub	끕
ggeubs	끖
ggeus	끗
ggeuss	끘
ggeung	끙
ggeuj	끚
ggeuc	끛
ggeuk	끜
ggeut	끝
ggeup	끞
ggeuh	끟
ggyi	끠
ggyig	끡
ggyigg	끢
ggyigs	끣
ggyin	끤
ggyinj	끥
ggyinh	끦
ggyid	끧
ggyil	끨
ggyilg	끩
ggyilm	끪
ggyilb	끫
ggyils	끬
ggyilt	끭
ggyilp	끮
ggyilh	끯
ggyim	끰
ggyib	끱
ggyibs	끲
ggyis	끳
ggyiss	끴
ggying	끵
ggyij	끶
ggyic	끷
ggyik	끸
ggyit	끹
ggyip	끺
ggyih	끻
ggi	끼
ggig	끽
ggigg	끾
ggigs	끿
ggin	낀
gginj	낁
gginh	낂
ggid	낃
ggil	낄
ggilg	낅
ggilm	낆
ggilb	낇
ggils	낈
ggilt	낉
ggilp	낊
ggilh	낋
ggim	낌
ggib	낍
ggibs	낎
ggis	낏
ggiss	낐
gging	낑
ggij	낒
ggic	낓
ggik	낔
ggit	낕
ggip	낖
ggih	낗
na	나
nag	낙
nagg	낚
nags	낛
nan	난
nanj	낝
nanh	낞
nad	낟
nal	날
nalg	낡
nalm	낢
nalb	낣
nals	낤
nalt	낥
nalp	낦
nalh	낧
nam	남
nab	납
nabs	낪
nas	낫
nass	났
nang	낭
naj	낮
nac	낯
nak	낰
nat	낱
nap	낲
nah	낳
nae	내
naeg	낵
naegg	낶
naegs	낷
naen	낸
naenj	낹
naenh	낺
naed	낻
nael	낼
naelg	낽
naelm	낾
naelb	낿
naels	냀
naelt	냁
naelp	냂
naelh	냃
naem	냄
naeb	냅
naebs	냆
naes	냇
naess	냈
naeng	냉
naej	냊
naec	냋
naek	냌
naet	냍
naep	냎
naeh	냏
nya	냐
nyag	냑
nyagg	냒
nyags	냓
nyan	냔
nyanj	냕
nyanh	냖
nyad	냗
nyal	냘
nyalg	냙
nyalm	냚
nyalb	냛
nyals	냜
nyalt	냝
nyalp	냞
nyalh	냟
nyam	냠
nyab	냡
nyabs	냢
nyas	냣
nyass	냤
nyang	냥
nyaj	냦
nyac	냧
nyak	냨
nyat	냩
nyap	냪
nyah	냫
nyae	냬
nyaeg	냭
nyaegg	냮
nyaegs	냯
nyaen	냰
nyaenj	냱
nyaenh	냲
nyaed	냳
nyael	냴
nyaelg	냵
nyaelm	냶
nyaelb	냷
nyaels	냸
nyaelt	냹
nyaelp	냺
nyaelh	냻
nyaem	냼
nyaeb	냽
nyaebs	냾
nyaes	냿
nyaess	넀
nyaeng	넁
nyaej	넂
nyaec	넃
nyaek	넄
nyaet	넅
nyaep	넆
nyaeh	넇
neo	너
neog	넉
neogg	넊
neogs	넋
neon	넌
neonj	넍
neonh	넎
neod	넏
neol	널
neolg	넑
neolm	넒
neolb	넓
neols	넔
neolt	넕
neolp	넖
neolh	넗
neom	넘
neob	넙
neobs	넚
neos	넛
neoss	넜
neong	넝
neoj	넞
neoc	넟
neok	넠
neot	넡
neop	넢
neoh	넣
ne	네
neg	넥
negg	넦
negs	넧
nen	넨
nenj	넩
nenh	넪
ned	넫
nel	넬
nelg	넭
nelm	넮
nelb	넯
nels	넰
nelt	넱
nelp	넲
nelh	넳
nem	넴
neb	넵
nebs	넶
nes	넷
ness	넸
neng	넹
nej	넺
nec	넻
nek	넼
net	넽
nep	넾
neh	넿
nyeo	녀
nyeog	녁
nyeogg	녂
nyeogs	녃
nyeon	년
nyeonj	녅
nyeonh	녆
nyeod	녇
nyeol	녈
nyeolg	녉
nyeolm	녊
nyeolb	녋
nyeols	녌
nyeolt	녍
nyeolp	녎
nyeolh	녏
nyeom	념
nyeob	녑
nyeobs	녒
nyeos	녓
nyeoss	녔
nyeong	녕
nyeoj	녖
nyeoc	녗
nyeok	녘
nyeot	녙
nyeop	녚
nyeoh	녛
nye	녜
nyeg	녝
nyegg	녞
nyegs	녟
nyen	녠
nyenj	녡
nyenh	녢
nyed	녣
nyel	녤
nyelg	녥
nyelm	녦
nyelb	녧
nyels	녨
nyelt	녩
nyelp	녪
nyelh	녫
nyem	녬
nyeb	녭
nyebs	녮
nyes	녯
nyess	녰
nyeng	녱
nyej	녲
nyec	녳
nyek	녴
nyet	녵
nyep	녶
nyeh	녷
no	노
nog	녹
nogg	녺
nogs	녻
non	논
nonj	녽
nonh	녾
nod	녿
nol	놀
nolg	놁
nolm	놂
nolb	놃
nols	놄
nolt	놅
nolp	놆
nolh	놇
nom	놈
nob	놉
nobs	놊
nos	놋
noss	놌
nong	농
noj	놎
noc	놏
nok	놐
not	놑
nop	높
noh	놓
nwa	놔
nwag	놕
nwagg	놖
nwags	놗
nwan	놘
nwanj	놙
nwanh	놚
nwad	놛
nwal	놜
nwalg	놝
nwalm	놞
nwalb	놟
nwals	놠
nwalt	놡
nwalp	놢
nwalh	놣
nwam	놤
nwab	놥
nwabs	놦
nwas	놧
nwass	놨
nwang	놩
nwaj	놪
nwac	놫
nwak	놬
nwat	놭
nwap	놮
nwah	놯
nwae	놰
nwaeg	놱
nwaegg	놲
nwaegs	놳
nwaen	놴
nwaenj	놵
nwaenh	놶
nwaed	놷
nwael	놸
nwaelg	놹
nwaelm	놺
nwaelb	놻
nwaels	놼
nwaelt	놽
nwaelp	놾
nwaelh	놿
nwaem	뇀
nwaeb	뇁
nwaebs	뇂
nwaes	뇃
nwaess	뇄
nwaeng	뇅
nwaej	뇆
nwaec	뇇
nwaek	뇈
nwaet	뇉
nwaep	뇊
nwaeh	뇋
noe	뇌
noeg	뇍
noegg	뇎
noegs	뇏
noen	뇐
noenj	뇑
noenh	뇒
noed	뇓
noel	뇔
noelg	뇕
noelm	뇖
noelb	뇗
noels	뇘
noelt	뇙
noelp	뇚
noelh	뇛
noem	뇜
noeb	뇝
noebs	뇞
noes	뇟
noess	뇠
noeng	뇡
noej	뇢
noec	뇣
noek	뇤
noet	뇥
noep	뇦
noeh	뇧
nyo	뇨
nyog	뇩
nyogg	뇪
nyogs	뇫
nyon	뇬
nyonj	뇭
nyonh	뇮
nyod	뇯
nyol	뇰
nyolg	뇱
nyolm	뇲
nyolb	뇳
nyols	뇴
nyolt	뇵
nyolp	뇶
nyolh	뇷
nyom	뇸
nyob	뇹
nyobs	뇺
nyos	뇻
nyoss	뇼
nyong	뇽
nyoj	뇾
nyoc	뇿
nyok	눀
nyot	눁
nyop	눂
nyoh	눃
nu	누
nug	눅
nugg	눆
nugs	눇
nun	눈
nunj	눉
nunh	눊
nud	눋
nul	눌
nulg	눍
nulm	눎
nulb	눏
nuls	눐
nult	눑
nulp	눒
nulh	눓
num	눔
nub	눕
nubs	눖
nus	눗
nuss	눘
nung	눙
nuj	눚
nuc	눛
nuk	눜
nut	눝
nup	눞
nuh	눟
nweo	눠
nweog	눡
nweogg	눢
nweogs	눣
nweon	눤
nweonj	눥
nweonh	눦
nweod	눧
nweol	눨
nweolg	눩
nweolm	눪
nweolb	눫
nweols	눬
nweolt	눭
nweolp	눮
nweolh	눯
nweom	눰
nweob	눱
nweobs	눲
nweos	눳
nweoss	눴
nweong	눵
nweoj	눶
nweoc	눷
nweok	눸
nweot	눹
nweop	눺
nweoh	눻
nwe	눼
nweg	눽
nwegg	눾
nwegs	눿
nwen	뉀
nwenj	뉁
nwenh	뉂
nwed	뉃
nwel	뉄
nwelg	뉅
nwelm	뉆
nwelb	뉇
nwels	뉈
nwelt	뉉
nwelp	뉊
nwelh	뉋
nwem	뉌
nweb	뉍
nwebs	뉎
nwes	뉏
nwess	뉐
nweng	뉑
nwej	뉒
nwec	뉓
nwek	뉔
nwet	뉕
nwep	뉖
nweh	뉗
nwi	뉘
nwig	뉙
nwigg	뉚
nwigs	뉛
nwin	뉜
nwinj	뉝
nwinh	뉞
nwid	뉟
nwil	뉠
nwilg	뉡
nwilm	뉢
nwilb	뉣
nwils	뉤
nwilt	뉥
nwilp	뉦
nwilh	뉧
nwim	뉨
nwib	뉩
nwibs	뉪
nwis	뉫
nwiss	뉬
nwing	뉭
nwij	뉮
nwic	뉯
nwik	뉰
nwit	뉱
nwip	뉲
nwih	뉳
nyu	뉴
nyug	뉵
nyugg	뉶
nyugs	뉷
nyun	뉸
nyunj	뉹
nyunh	뉺
nyud	뉻
nyul	뉼
nyulg	뉽
nyulm	뉾
nyulb	뉿
nyuls	늀
nyult	늁
nyulp	늂
nyulh	늃
nyum	늄
nyub	늅
nyubs	늆
nyus	늇
nyuss	늈
nyung	늉
nyuj	늊
nyuc	늋
nyuk	늌
nyut	늍
nyup	늎
nyuh	늏
neu	느
neug	늑
neugg	늒
neugs	늓
neun	는
neunj	늕
neunh	늖
neud	늗
neul	늘
neulg	늙
neulm	늚
neulb	늛
neuls	늜
neult	늝
neulp	늞
neulh	늟
neum	늠
neub	늡
neubs	늢
neus	늣
neuss	늤
neung	능
neuj	늦
neuc	늧
neuk	늨
neut	늩
neup	늪
neuh	늫
nyi	늬
nyig	늭
nyigg	늮
nyigs	늯
nyin	늰
nyinj	늱
nyinh	늲
nyid	늳
nyil	늴
nyilg	늵
nyilm	늶
nyilb	늷
nyils	늸
nyilt	늹
nyilp	늺
nyilh	늻
nyim	늼
nyib	늽
nyibs	늾
nyis	늿
nyiss	닀
nying	닁
nyij	닂
nyic	닃
nyik	닄
nyit	닅
nyip	닆
nyih	닇
ni	니
nig	닉
nigg	닊
nigs	닋
nin	닌
ninj	닍
ninh	닎
nid	닏
nil	닐
nilg	닑
nilm	닒
nilb	닓
nils	닔
nilt	닕
nilp	닖
nilh	닗
nim	님
nib	닙
nibs	닚
nis	닛
niss	닜
ning	닝
nij	닞
nic	닟
nik	닠
nit	닡
nip	닢
nih	닣
da	다
dag	닥
dagg	닦
dags	닧
dan	단
danj	닩
danh	닪
dad	닫
dal	달
dalg	닭
dalm	닮
dalb	닯
dals	닰
dalt	닱
dalp	닲
dalh	닳
dam	담
dab	답
dabs	닶
das	닷
dass	닸
dang	당
daj	닺
dac	닻
dak	닼
dat	닽
dap	닾
dah	닿
dae	대
daeg	댁
daegg	댂
daegs	댃
daen	댄
daenj	댅
daenh	댆
daed	댇
dael	댈
daelg	댉
daelm	댊
daelb	댋
daels	댌
daelt	댍
daelp	댎
daelh	댏
daem	댐
daeb	댑
daebs	댒
daes	댓
daess	댔
daeng	댕
daej	댖
daec	댗
daek	댘
daet	댙
daep	댚
daeh	댛
dya	댜
dyag	댝
dyagg	댞
dyags	댟
dyan	댠
dyanj	댡
dyanh	댢
dyad	댣
dyal	댤
dyalg	댥
dyalm	댦
dyalb	댧
dyals	댨
dyalt	댩
dyalp	댪
dyalh	댫
dyam	댬
dyab	댭
dyabs	댮
dyas	댯
dyass	댰
dyang	댱
dyaj	댲
dyac	댳
dyak	댴
dyat	댵
dyap	댶
dyah	댷
dyae	댸
dyaeg	댹
dyaegg	댺
dyaegs	댻
dyaen	댼
dyaenj	댽
dyaenh	댾
dyaed	댿
dyael	덀
dyaelg	덁
dyaelm	덂
dyaelb	덃
dyaels	덄
dyaelt	덅
dyaelp	덆
dyaelh	덇
dyaem	덈
dyaeb	덉
dyaebs	덊
dyaes	덋
dyaess	덌
dyaeng	덍
dyaej	덎
dyaec	덏
dyaek	덐
dyaet	덑
dyaep	덒
dyaeh	덓
deo	더
deog	덕
deogg	덖
deogs	덗
deon	던
deonj	덙
deonh	덚
deod	덛
deol	덜
deolg	덝
deolm	덞
deolb	덟
deols	덠
deolt	덡
deolp	덢
deolh	덣
deom	덤
deob	덥
deobs	덦
deos	덧
deoss	덨
deong	덩
deoj	덪
deoc	덫
deok	덬
deot	덭
deop	덮
deoh	덯
de	데
deg	덱
degg	덲
degs	덳
den	덴
denj	덵
denh	덶
ded	덷
del	델
delg	덹
delm	덺
delb	덻
dels	덼
delt	덽
delp	덾
delh	덿
dem	뎀
deb	뎁
debs	뎂
des	뎃
dess	뎄
deng	뎅
dej	뎆
dec	뎇
dek	뎈
det	뎉
dep	뎊
deh	뎋
dyeo	뎌
dyeog	뎍
dyeogg	뎎
dyeogs	뎏
dyeon	뎐
dyeonj	뎑
dyeonh	뎒
dyeod	뎓
dyeol	뎔
dyeolg	뎕
dyeolm	뎖
dyeolb	뎗
dyeols	뎘
dyeolt	뎙
dyeolp	뎚
dyeolh	뎛
dyeom	뎜
dyeob	뎝
dyeobs	뎞
dyeos	뎟
dyeoss	뎠
dyeong	뎡
dyeoj	뎢
dyeoc	뎣
dyeok	뎤
dyeot	뎥
dyeop	뎦
dyeoh	뎧
dye	뎨
dyeg	뎩
dyegg	뎪
dyegs	뎫
dyen	뎬
dyenj	뎭
dyenh	뎮
dyed	뎯
dyel	뎰
dyelg	뎱
dyelm	뎲
dyelb	뎳
dyels	뎴
dyelt	뎵
dyelp	뎶
dyelh	뎷
dyem	뎸
dyeb	뎹
dyebs	뎺
dyes	뎻
dyess	뎼
dyeng	뎽
dyej	뎾
dyec	뎿
dyek	돀
dyet	돁
dyep	돂
dyeh	돃
do	도
dog	독
dogg	돆
dogs	돇
don	돈
donj	돉
donh	돊
dod	돋
dol	돌
dolg	돍
dolm	돎
dolb	돏
dols	돐
dolt	돑
dolp	돒
dolh	돓
dom	돔
dob	돕
dobs	돖
dos	돗
doss	돘
dong	동
doj	돚
doc	돛
dok	돜
dot	돝
dop	돞
doh	돟
dwa	돠
dwag	돡
dwagg	돢
dwags	돣
dwan	돤
dwanj	돥
dwanh	돦
dwad	돧
dwal	돨
dwalg	돩
dwalm	돪
dwalb	돫
dwals	돬
dwalt	돭
dwalp	돮
dwalh	돯
dwam	돰
dwab	돱
dwabs	돲
dwas	돳
dwass	돴
dwang	돵
dwaj	돶
dwac	돷
dwak	돸
dwat	돹
dwap	돺
dwah	돻
dwae	돼
dwaeg	돽
dwaegg	돾
dwaegs	돿
dwaen	됀
dwaenj	됁
dwaenh	됂
dwaed	됃
dwael	됄
dwaelg	됅
dwaelm	됆
dwaelb	됇
dwaels	됈
dwaelt	됉
dwaelp	됊
dwaelh	됋
dwaem	됌
dwaeb	됍
dwaebs	됎
dwaes	됏
dwaess	됐
dwaeng	됑
dwaej	됒
dwaec	됓
dwaek	됔
dwaet	됕
dwaep	됖
dwaeh	됗
doe	되
doeg	됙
doegg	됚
doegs	됛
doen	된
doenj	됝
doenh	됞
doed	됟
doel	될
doelg	됡
doelm	됢
doelb	됣
doels	됤
doelt	됥
doelp	됦
doelh	됧
doem	됨
doeb	됩
doebs	됪
does	됫
doess	됬
doeng	됭
doej	됮
doec	됯
doek	됰
doet	됱
doep	됲
doeh	됳
dyo	됴
dyog	됵
dyogg	됶
dyogs	됷
dyon	됸
dyonj	됹
dyonh	됺
dyod	됻
dyol	됼
dyolg	됽
dyolm	됾
dyolb	됿
dyols	둀
dyolt	둁
dyolp	둂
dyolh	둃
dyom	둄
dyob	둅
dyobs	둆
dyos	둇
dyoss	둈
dyong	둉
dyoj	둊
dyoc	둋
dyok	둌
dyot	둍
dyop	둎
dyoh	둏
du	두
dug	둑
dugg	둒
dugs	둓
dun	둔
dunj	둕
dunh	둖
dud	둗
dul	둘
dulg	둙
dulm	둚
dulb	둛
duls	둜
dult	둝
dulp	둞
dulh	둟
dum	둠
dub	둡
dubs	둢
dus	둣
duss	둤
dung	둥
duj	둦
duc	둧
duk	둨
dut	둩
dup	둪
duh	둫
dweo	둬
dweog	둭
dweogg	둮
dweogs	둯
dweon	둰
dweonj	둱
dweonh	둲
dweod	둳
dweol	둴
dweolg	둵
dweolm	둶
dweolb	둷
dweols	둸
dweolt	둹
dweolp	둺
dweolh	둻
dweom	둼
dweob	둽
dweobs	둾
dweos	둿
dweoss	뒀
dweong	뒁
dweoj	뒂
dweoc	뒃
dweok	뒄
dweot	뒅
dweop	뒆
dweoh	뒇
dwe	뒈
dweg	뒉
dwegg	뒊
dwegs	뒋
dwen	뒌
dwenj	뒍
dwenh	뒎
dwed	뒏
dwel	뒐
dwelg	뒑
dwelm	뒒
dwelb	뒓
dwels	뒔
dwelt	뒕
dwelp	뒖
dwelh	뒗
dwem	뒘
dweb	뒙
dwebs	뒚
dwes	뒛
dwess	뒜
dweng	뒝
dwej	뒞
dwec	뒟
dwek	뒠
dwet	뒡
dwep	뒢
dweh	뒣
dwi	뒤
dwig	뒥
dwigg	뒦
dwigs	뒧
dwin	뒨
dwinj	뒩
dwinh	뒪
dwid	뒫
dwil	뒬
dwilg	뒭
dwilm	뒮
dwilb	뒯
dwils	뒰
dwilt	뒱
dwilp	뒲
dwilh	뒳
dwim	뒴
dwib	뒵
dwibs	뒶
dwis	뒷
dwiss	뒸
dwing	뒹
dwij	뒺
dwic	뒻
dwik	뒼
dwit	뒽
dwip	뒾
dwih	뒿
dyu	듀
dyug	듁
dyugg	듂
dyugs	듃
dyun	듄
dyunj	듅
dyunh	듆
dyud	듇
dyul	듈
dyulg	듉
dyulm	듊
dyulb	듋
dyuls	듌
dyult	듍
dyulp	듎
dyulh	듏
dyum	듐
dyub	듑
dyubs	듒
dyus	듓
dyuss	듔
dyung	듕
dyuj	듖
dyuc	듗
dyuk	듘
dyut	듙
dyup	듚
dyuh	듛
deu	드
deug	득
deugg	듞
deugs	듟
deun	든
deunj	듡
deunh	듢
deud	듣
deul	들
deulg	듥
deulm	듦
deulb	듧
deuls	듨
deult	듩
deulp	듪
deulh	듫
deum	듬
deub	듭
deubs	듮
deus	듯
deuss	듰
deung	등
deuj	듲
deuc	듳
deuk	듴
deut	듵
deup	듶
deuh	듷
dyi	듸
dyig	듹
dyigg	듺
dyigs	듻
dyin	듼
dyinj	듽
dyinh	듾
dyid	듿
dyil	딀
dyilg	딁
dyilm	딂
dyilb	딃
dyils	딄
dyilt	딅
dyilp	딆
dyilh	딇
dyim	딈
dyib	딉
dyibs	딊
dyis	딋
dyiss	딌
dying	딍
dyij	딎
dyic	딏
dyik	딐
dyit	딑
dyip	딒
dyih	딓
di	디
dig	딕
digg	딖
digs	딗
din	딘
dinj	딙
dinh	딚
did	딛
dil	딜
dilg	딝
dilm	딞
dilb	딟
dils	딠
dilt	딡
dilp	딢
dilh	딣
dim	딤
dib	딥
dibs	딦
dis	딧
diss	딨
ding	딩
dij	딪
dic	딫
dik	딬
dit	딭
dip	딮
dih	딯
dda	따
ddag	딱
ddagg	딲
ddags	딳
ddan	딴
ddanj	딵
ddanh	딶
ddad	딷
ddal	딸
ddalg	딹
ddalm	딺
ddalb	딻
ddals	딼
ddalt	딽
ddalp	딾
ddalh	딿
ddam	땀
ddab	땁
ddabs	땂
ddas	땃
ddass	땄
ddang	땅
ddaj	땆
ddac	땇
ddak	땈
ddat	땉
ddap	땊
ddah	땋
ddae	때
ddaeg	땍
ddaegg	땎
ddaegs	땏
ddaen	땐
ddaenj	땑
ddaenh	땒
ddaed	땓
ddael	땔
ddaelg	땕
ddaelm	땖
ddaelb	땗
ddaels	땘
ddaelt	땙
ddaelp	땚
ddaelh	땛
ddaem	땜
ddaeb	땝
ddaebs	땞
ddaes	땟
ddaess	땠
ddaeng	땡
ddaej	땢
ddaec	땣
ddaek	땤
ddaet	땥
ddaep	땦
ddaeh	땧
ddya	땨
ddyag	땩
ddyagg	땪
ddyags	땫
ddyan	땬
ddyanj	땭
ddyanh	땮
ddyad	땯
ddyal	땰
ddyalg	땱
ddyalm	땲
ddyalb	땳
ddyals	땴
ddyalt	땵
ddyalp	땶
ddyalh	땷
ddyam	땸
ddyab	땹
ddyabs	땺
ddyas	땻
ddyass	땼
ddyang	땽
ddyaj	땾
ddyac	땿
ddyak	떀
ddyat	떁
ddyap	떂
ddyah	떃
ddyae	떄
ddyaeg	떅
ddyaegg	떆
ddyaegs	떇
ddyaen	떈
ddyaenj	떉
ddyaenh	떊
ddyaed	떋
ddyael	떌
ddyaelg	떍
ddyaelm	떎
ddyaelb	떏
ddyaels	떐
ddyaelt	떑
ddyaelp	떒
ddyaelh	떓
ddyaem	떔
ddyaeb	떕
ddyaebs	떖
ddyaes	떗
ddyaess	떘
ddyaeng	떙
ddyaej	떚
ddyaec	떛
ddyaek	떜
ddyaet	떝
ddyaep	떞
ddyaeh	떟
ddeo	떠
ddeog	떡
ddeogg	떢
ddeogs	떣
ddeon	떤
ddeonj	떥
ddeonh	떦
ddeod	떧
ddeol	떨
ddeolg	떩
ddeolm	떪
ddeolb	떫
ddeols	떬
ddeolt	떭
ddeolp	떮
ddeolh	떯
ddeom	떰
ddeob	떱
ddeobs	떲
ddeos	떳
ddeoss	떴
ddeong	떵
ddeoj	떶
ddeoc	떷
ddeok	떸
ddeot	떹
ddeop	떺
ddeoh	떻
dde	떼
ddeg	떽
ddegg	떾
ddegs	떿
dden	뗀
ddenj	뗁
ddenh	뗂
dded	뗃
ddel	뗄
ddelg	뗅
ddelm	뗆
ddelb	뗇
ddels	뗈
ddelt	뗉
ddelp	뗊
ddelh	뗋
ddem	뗌
ddeb	뗍
ddebs	뗎
ddes	뗏
ddess	뗐
ddeng	뗑
ddej	뗒
ddec	뗓
ddek	뗔
ddet	뗕
ddep	뗖
ddeh	뗗
ddyeo	뗘
ddyeog	뗙
ddyeogg	뗚
ddyeogs	뗛
ddyeon	뗜
ddyeonj	뗝
ddyeonh	뗞
ddyeod	뗟
ddyeol	뗠
ddyeolg	뗡
ddyeolm	뗢
ddyeolb	뗣
ddyeols	뗤
ddyeolt	뗥
ddyeolp	뗦
ddyeolh	뗧
ddyeom	뗨
ddyeob	뗩
ddyeobs	뗪
ddyeos	뗫
ddyeoss	뗬
ddyeong	뗭
ddyeoj	뗮
ddyeoc	뗯
ddyeok	뗰
ddyeot	뗱
ddyeop	뗲
ddyeoh	뗳
ddye	뗴
ddyeg	뗵
ddyegg	뗶
ddyegs	뗷
ddyen	뗸
ddyenj	뗹
ddyenh	뗺
ddyed	뗻
ddyel	뗼
ddyelg	뗽
ddyelm	뗾
ddyelb	뗿
ddyels	똀
ddyelt	똁
ddyelp	똂
ddyelh	똃
ddyem	똄
ddyeb	똅
ddyebs	똆
ddyes	똇
ddyess	똈
ddyeng	똉
ddyej	똊
ddyec	똋
ddyek	똌
ddyet	똍
ddyep	똎
ddyeh	똏
ddo	또
ddog	똑
ddogg	똒
ddogs	똓
ddon	똔
ddonj	똕
ddonh	똖
ddod	똗
ddol	똘
ddolg	똙
ddolm	똚
ddolb	똛
ddols	똜
ddolt	똝
ddolp	똞
ddolh	똟
ddom	똠
ddob	똡
ddobs	똢
ddos	똣
ddoss	똤
ddong	똥
ddoj	똦
ddoc	똧
ddok	똨
ddot	똩
ddop	똪
ddoh	똫
ddwa	똬
ddwag	똭
ddwagg	똮
ddwags	똯
ddwan	똰
ddwanj	똱
ddwanh	똲
ddwad	똳
ddwal	똴
ddwalg	똵
ddwalm	똶
ddwalb	똷
ddwals	똸
ddwalt	똹
ddwalp	똺
ddwalh	똻
ddwam	똼
ddwab	똽
ddwabs	똾
ddwas	똿
ddwass	뙀
ddwang	뙁
ddwaj	뙂
ddwac	뙃
ddwak	뙄
ddwat	뙅
ddwap	뙆
ddwah	뙇
ddwae	뙈
ddwaeg	뙉
ddwaegg	뙊
ddwaegs	뙋
ddwaen	뙌
ddwaenj	뙍
ddwaenh	뙎
ddwaed	뙏
ddwael	뙐
ddwaelg	뙑
ddwaelm	뙒
ddwaelb	뙓
ddwaels	뙔
ddwaelt	뙕
ddwaelp	뙖
ddwaelh	뙗
ddwaem	뙘
ddwaeb	뙙
ddwaebs	뙚
ddwaes	뙛
ddwaess	뙜
ddwaeng	뙝
ddwaej	뙞
ddwaec	뙟
ddwaek	뙠
ddwaet	뙡
ddwaep	뙢
ddwaeh	뙣
ddoe	뙤
ddoeg	뙥
ddoegg	뙦
ddoegs	뙧
ddoen	뙨
ddoenj	뙩
ddoenh	뙪
ddoed	뙫
ddoel	뙬
ddoelg	뙭
ddoelm	뙮
ddoelb	뙯
ddoels	뙰
ddoelt	뙱
ddoelp	뙲
ddoelh	뙳
ddoem	뙴
ddoeb	뙵
ddoebs	뙶
ddoes	뙷
ddoess	뙸
ddoeng	뙹
ddoej	뙺
ddoec	뙻
ddoek	뙼
ddoet	뙽
ddoep	뙾
ddoeh	뙿
ddyo	뚀
ddyog	뚁
ddyogg	뚂
ddyogs	뚃
ddyon	뚄
ddyonj	뚅
ddyonh	뚆
ddyod	뚇
ddyol	뚈
ddyolg	뚉
ddyolm	뚊
ddyolb	뚋
ddyols	뚌
ddyolt	뚍
ddyolp	뚎
ddyolh	뚏
ddyom	뚐
ddyob	뚑
ddyobs	뚒
ddyos	뚓
ddyoss	뚔
ddyong	뚕
ddyoj	뚖
ddyoc	뚗
ddyok	뚘
ddyot	뚙
ddyop	뚚
ddyoh	뚛
ddu	뚜
ddug	뚝
ddugg	뚞
ddugs	뚟
ddun	뚠
ddunj	뚡
ddunh	뚢
ddud	뚣
ddul	뚤
ddulg	뚥
ddulm	뚦
ddulb	뚧
dduls	뚨
ddult	뚩
ddulp	뚪
ddulh	뚫
ddum	뚬
ddub	뚭
ddubs	뚮
ddus	뚯
dduss	뚰
ddung	뚱
dduj	뚲
dduc	뚳
dduk	뚴
ddut	뚵
ddup	뚶
dduh	뚷
ddweo	뚸
ddweog	뚹
ddweogg	뚺
ddweogs	뚻
ddweon	뚼
ddweonj	뚽
ddweonh	뚾
ddweod	뚿
ddweol	뛀
ddweolg	뛁
ddweolm	뛂
ddweolb	뛃
ddweols	뛄
ddweolt	뛅
ddweolp	뛆
ddweolh	뛇
ddweom	뛈
ddweob	뛉
ddweobs	뛊
ddweos	뛋
ddweoss	뛌
ddweong	뛍
ddweoj	뛎
ddweoc	뛏
ddweok	뛐
ddweot	뛑
ddweop	뛒
ddweoh	뛓
ddwe	뛔
ddweg	뛕
ddwegg	뛖
ddwegs	뛗
ddwen	뛘
ddwenj	뛙
ddwenh	뛚
ddwed	뛛
ddwel	뛜
ddwelg	뛝
ddwelm	뛞
ddwelb	뛟
ddwels	뛠
ddwelt	뛡
ddwelp	뛢
ddwelh	뛣
ddwem	뛤
ddweb	뛥
ddwebs	뛦
ddwes	뛧
ddwess	뛨
ddweng	뛩
ddwej	뛪
ddwec	뛫
ddwek	뛬
ddwet	뛭
ddwep	뛮
ddweh	뛯
ddwi	뛰
ddwig	뛱
ddwigg	뛲
ddwigs	뛳
ddwin	뛴
ddwinj	뛵
ddwinh	뛶
ddwid	뛷
ddwil	뛸
ddwilg	뛹
ddwilm	뛺
ddwilb	뛻
ddwils	뛼
ddwilt	뛽
ddwilp	뛾
ddwilh	뛿
ddwim	뜀
ddwib	뜁
ddwibs	뜂
ddwis	뜃
ddwiss	뜄
ddwing	뜅
ddwij	뜆
ddwic	뜇
ddwik	뜈
ddwit	뜉
ddwip	뜊
ddwih	뜋
ddyu	뜌
ddyug	뜍
ddyugg	뜎
ddyugs	뜏
ddyun	뜐
ddyunj	뜑
ddyunh	뜒
ddyud	뜓
ddyul	뜔
ddyulg	뜕
ddyulm	뜖
ddyulb	뜗
ddyuls	뜘
ddyult	뜙
ddyulp	뜚
ddyulh	뜛
ddyum	뜜
ddyub	뜝
ddyubs	뜞
ddyus	뜟
ddyuss	뜠
ddyung	뜡
ddyuj	뜢
ddyuc	뜣
ddyuk	뜤
ddyut	뜥
ddyup	뜦
ddyuh	뜧
ddeu	뜨
ddeug	뜩
ddeugg	뜪
ddeugs	뜫
ddeun	뜬
ddeunj	뜭
ddeunh	뜮
ddeud	뜯
ddeul	뜰
ddeulg	뜱
ddeulm	뜲
ddeulb	뜳
ddeuls	뜴
ddeult	뜵
ddeulp	뜶
ddeulh	뜷
ddeum	뜸
ddeub	뜹
ddeubs	뜺
ddeus	뜻
ddeuss	뜼
ddeung	뜽
ddeuj	뜾
ddeuc	뜿
ddeuk	띀
ddeut	띁
ddeup	띂
ddeuh	띃
ddyi	띄
ddyig	띅
ddyigg	띆
ddyigs	띇
ddyin	띈
ddyinj	띉
ddyinh	띊
ddyid	띋
ddyil	띌
ddyilg	띍
ddyilm	띎
ddyilb	띏
ddyils	띐
ddyilt	띑
ddyilp	띒
ddyilh	띓
ddyim	띔
ddyib	띕
ddyibs	띖
ddyis	띗
ddyiss	띘
ddying	띙
ddyij	띚
ddyic	띛
ddyik	띜
ddyit	띝
ddyip	띞
ddyih	띟
ddi	띠
ddig	띡
ddigg	띢
ddigs	띣
ddin	띤
ddinj	띥
ddinh	띦
ddid	띧
ddil	띨
ddilg	띩
ddilm	띪
ddilb	띫
ddils	띬
ddilt	띭
ddilp	띮
ddilh	띯
ddim	띰
ddib	띱
ddibs	띲
ddis	띳
ddiss	띴
dding	띵
ddij	띶
ddic	띷
ddik	띸
ddit	띹
ddip	띺
ddih	띻
ra	라
rag	락
ragg	띾
rags	띿
ran	란
ranj	랁
ranh	랂
rad	랃
ral	랄
ralg	랅
ralm	랆
ralb	랇
rals	랈
ralt	랉
ralp	랊
ralh	랋
ram	람
rab	랍
rabs	랎
ras	랏
rass	랐
rang	랑
raj	랒
rac	랓
rak	랔
rat	랕
rap	랖
rah	랗
rae	래
raeg	랙
raegg	랚
raegs	랛
raen	랜
raenj	랝
raenh	랞
raed	랟
rael	랠
raelg	랡
raelm	랢
raelb	랣
raels	랤
raelt	랥
raelp	랦
raelh	랧
raem	램
raeb	랩
raebs	랪
raes	랫
raess	랬
raeng	랭
raej	랮
raec	랯
raek	랰
raet	랱
raep	랲
raeh	랳
rya	랴
ryag	략
ryagg	랶
ryags	랷
ryan	랸
ryanj	랹
ryanh	랺
ryad	랻
ryal	랼
ryalg	랽
ryalm	랾
ryalb	랿
ryals	럀
ryalt	럁
ryalp	럂
ryalh	럃
ryam	럄
ryab	럅
ryabs	럆
ryas	럇
ryass	럈
ryang	량
ryaj	럊
ryac	럋
ryak	럌
ryat	럍
ryap	럎
ryah	럏
ryae	럐
ryaeg	럑
ryaegg	럒
ryaegs	럓
ryaen	럔
ryaenj	럕
ryaenh	럖
ryaed	럗
ryael	럘
ryaelg	럙
ryaelm	럚
ryaelb	럛
ryaels	럜
ryaelt	럝
ryaelp	럞
ryaelh	럟
ryaem	럠
ryaeb	럡
ryaebs	럢
ryaes	럣
ryaess	럤
ryaeng	럥
ryaej	럦
ryaec	럧
ryaek	럨
ryaet	럩
ryaep	럪
ryaeh	럫
reo	러
reog	럭
reogg	럮
reogs	럯
reon	런
reonj	럱
reonh	럲
reod	럳
reol	럴
reolg	럵
reolm	럶
reolb	럷
reols	럸
reolt	럹
reolp	럺
reolh	럻
reom	럼
reob	럽
reobs	럾
reos	럿
reoss	렀
reong	렁
reoj	렂
reoc	렃
reok	렄
reot	렅
reop	렆
reoh	렇
re	레
reg	렉
regg	렊
regs	렋
ren	렌
renj	렍
renh	렎
red	렏
rel	렐
relg	렑
relm	렒
relb	렓
rels	렔
relt	렕
relp	렖
relh	렗
rem	렘
reb	렙
rebs	렚
res	렛
ress	렜
reng	렝
rej	렞
rec	렟
rek	렠
ret	렡
rep	렢
reh	렣
ryeo	려
ryeog	력
ryeogg	렦
ryeogs	렧
ryeon	련
ryeonj	렩
ryeonh	렪
ryeod	렫
ryeol	렬
ryeolg	렭
ryeolm	렮
ryeolb	렯
ryeols	렰
ryeolt	렱
ryeolp	렲
ryeolh	렳
ryeom	렴
ryeob	렵
ryeobs	렶
ryeos	렷
ryeoss	렸
ryeong	령
ryeoj	렺
ryeoc	렻
ryeok	렼
ryeot	렽
ryeop	렾
ryeoh	렿
rye	례
ryeg	롁
ryegg	롂
ryegs	롃
ryen	롄
ryenj	롅
ryenh	롆
ryed	롇
ryel	롈
ryelg	롉
ryelm	롊
ryelb	롋
ryels	롌
ryelt	롍
ryelp	롎
ryelh	롏
ryem	롐
ryeb	롑
ryebs	롒
ryes	롓
ryess	롔
ryeng	롕
ryej	롖
ryec	롗
ryek	롘
ryet	롙
ryep	롚
ryeh	롛
ro	로
rog	록
rogg	롞
rogs	롟
ron	론
ronj	롡
ronh	롢
rod	롣
rol	롤
rolg	롥
rolm	롦
rolb	롧
rols	롨
rolt	롩
rolp	롪
rolh	롫
rom	롬
rob	롭
robs	롮
ros	롯
ross	롰
rong	롱
roj	롲
roc	롳
rok	롴
rot	롵
rop	롶
roh	롷
rwa	롸
rwag	롹
rwagg	롺
rwags	롻
rwan	롼
rwanj	롽
rwanh	롾
rwad	롿
rwal	뢀
rwalg	뢁
rwalm	뢂
rwalb	뢃
rwals	뢄
rwalt	뢅
rwalp	뢆
rwalh	뢇
rwam	뢈
rwab	뢉
rwabs	뢊
rwas	뢋
rwass	뢌
rwang	뢍
rwaj	뢎
rwac	뢏
rwak	뢐
rwat	뢑
rwap	뢒
rwah	뢓
rwae	뢔
rwaeg	뢕
rwaegg	뢖
rwaegs	뢗
rwaen	뢘
rwaenj	뢙
rwaenh	뢚
rwaed	뢛
rwael	뢜
rwaelg	뢝
rwaelm	뢞
rwaelb	뢟
rwaels	뢠
rwaelt	뢡
rwaelp	뢢
rwaelh	뢣
rwaem	뢤
rwaeb	뢥
rwaebs	뢦
rwaes	뢧
rwaess	뢨
rwaeng	뢩
rwaej	뢪
rwaec	뢫
rwaek	뢬
rwaet	뢭
rwaep	뢮
rwaeh	뢯
roe	뢰
roeg	뢱
roegg	뢲
roegs	뢳
roen	뢴
roenj	뢵
roenh	뢶
roed	뢷
roel	뢸
roelg	뢹
roelm	뢺
roelb	뢻
roels	뢼
roelt	뢽
roelp	뢾
roelh	뢿
roem	룀
roeb	룁
roebs	룂
roes	룃
roess	룄
roeng	룅
roej	룆
roec	룇
roek	룈
roet	룉
roep	룊
roeh	룋
ryo	료
ryog	룍
ryogg	룎
ryogs	룏
ryon	룐
ryonj	룑
ryonh	룒
ryod	룓
ryol	룔
ryolg	룕
ryolm	룖
ryolb	룗
ryols	룘
ryolt	룙
ryolp	룚
ryolh	룛
ryom	룜
ryob	룝
ryobs	룞
ryos	룟
ryoss	룠
ryong	룡
ryoj	룢
ryoc	룣
ryok	룤
ryot	룥
ryop	룦
ryoh	룧
ru	루
rug	룩
rugg	룪
rugs	룫
run	룬
runj	룭
runh	룮
rud	룯
rul	룰
rulg	룱
rulm	룲
rulb	룳
ruls	룴
rult	룵
rulp	룶
rulh	룷
rum	룸
rub	룹
rubs	룺
rus	룻
russ	룼
rung	룽
ruj	룾
ruc	룿
ruk	뤀
rut	뤁
rup	뤂
ruh	뤃
rweo	뤄
rweog	뤅
rweogg	뤆
rweogs	뤇
rweon	뤈
rweonj	뤉
rweonh	뤊
rweod	뤋
rweol	뤌
rweolg	뤍
rweolm	뤎
rweolb	뤏
rweols	뤐
rweolt	뤑
rweolp	뤒
rweolh	뤓
rweom	뤔
rweob	뤕
rweobs	뤖
rweos	뤗
rweoss	뤘
rweong	뤙
rweoj	뤚
rweoc	뤛
rweok	뤜
rweot	뤝
rweop	뤞
rweoh	뤟
rwe	뤠
rweg	뤡
rwegg	뤢
rwegs	뤣
rwen	뤤
rwenj	뤥
rwenh	뤦
rwed	뤧
rwel	뤨
rwelg	뤩
rwelm	뤪
rwelb	뤫
rwels	뤬
rwelt	뤭
rwelp	뤮
rwelh	뤯
rwem	뤰
rweb	뤱
rwebs	뤲
rwes	뤳
rwess	뤴
rweng	뤵
rwej	뤶
rwec	뤷
rwek	뤸
rwet	뤹
rwep	뤺
rweh	뤻
rwi	뤼
rwig	뤽
rwigg	뤾
rwigs	뤿
rwin	륀
rwinj	륁
rwinh	륂
rwid	륃
rwil	륄
rwilg	륅
rwilm	륆
rwilb	륇
rwils	륈
rwilt	륉
rwilp	륊
rwilh	륋
rwim	륌
rwib	륍
rwibs	륎
rwis	륏
rwiss	륐
rwing	륑
rwij	륒
rwic	륓
rwik	륔
rwit	륕
rwip	륖
rwih	륗
ryu	류
ryug	륙
ryugg	륚
ryugs	륛
ryun	륜
ryunj	륝
ryunh	륞
ryud	륟
ryul	률
ryulg	륡
ryulm	륢
ryulb	륣
ryuls	륤
ryult	륥
ryulp	륦
ryulh	륧
ryum	륨
ryub	륩
ryubs	륪
ryus	륫
ryuss	륬
ryung	륭
ryuj	륮
ryuc	륯
ryuk	륰
ryut	륱
ryup	륲
ryuh	륳
reu	르
reug	륵
reugg	륶
reugs	륷
reun	른
reunj	륹
reunh	륺
reud	륻
reul	를
reulg	륽
reulm	륾
reulb	륿
reuls	릀
reult	릁
reulp	릂
reulh	릃
reum	름
reub	릅
reubs	릆
reus	릇
reuss	릈
reung	릉
reuj	릊
reuc	릋
reuk	릌
reut	릍
reup	릎
reuh	릏
ryi	릐
ryig	릑
ryigg	릒
ryigs	릓
ryin	릔
ryinj	릕
ryinh	릖
ryid	릗
ryil	릘
ryilg	릙
ryilm	릚
ryilb	릛
ryils	릜
ryilt	릝
ryilp	릞
ryilh	릟
ryim	릠
ryib	릡
ryibs	릢
ryis	릣
ryiss	릤
rying	릥
ryij	릦
ryic	릧
ryik	릨
ryit	릩
ryip	릪
ryih	릫
ri	리
rig	릭
rigg	릮
rigs	릯
rin	린
rinj	릱
rinh	릲
rid	릳
ril	릴
rilg	릵
rilm	릶
rilb	릷
rils	릸
rilt	릹
rilp	릺
rilh	릻
rim	림
rib	립
ribs	릾
ris	릿
riss	맀
ring	링
rij	맂
ric	맃
rik	맄
rit	맅
rip	맆
rih	맇
ma	마
mag	막
magg	맊
mags	맋
man	만
manj	맍
manh	많
mad	맏
mal	말
malg	맑
malm	맒
malb	맓
mals	맔
malt	맕
malp	맖
malh	맗
mam	맘
mab	맙
mabs	맚
mas	맛
mass	맜
mang	망
maj	맞
mac	맟
mak	맠
mat	맡
map	맢
mah	맣
mae	매
maeg	맥
maegg	맦
maegs	맧
maen	맨
maenj	맩
maenh	맪
maed	맫
mael	맬
maelg	맭
maelm	맮
maelb	맯
maels	맰
maelt	맱
maelp	맲
maelh	맳
maem	맴
maeb	맵
maebs	맶
maes	맷
maess	맸
maeng	맹
maej	맺
maec	맻
maek	맼
maet	맽
maep	맾
maeh	맿
mya	먀
myag	먁
myagg	먂
myags	먃
myan	먄
myanj	먅
myanh	먆
myad	먇
myal	먈
myalg	먉
myalm	먊
myalb	먋
myals	먌
myalt	먍
myalp	먎
myalh	먏
myam	먐
myab	먑
myabs	먒
myas	먓
myass	먔
myang	먕
myaj	먖
myac	먗
myak	먘
myat	먙
myap	먚
myah	먛
myae	먜
myaeg	먝
myaegg	먞
myaegs	먟
myaen	먠
myaenj	먡
myaenh	먢
myaed	먣
myael	먤
myaelg	먥
myaelm	먦
myaelb	먧
myaels	먨
myaelt	먩
myaelp	먪
myaelh	먫
myaem	먬
myaeb	먭
myaebs	먮
myaes	먯
myaess	먰
myaeng	먱
myaej	먲
myaec	먳
myaek	먴
myaet	먵
myaep	먶
myaeh	먷
meo	머
meog	먹
meogg	먺
meogs	먻
meon	먼
meonj	먽
meonh	먾
meod	먿
meol	멀
meolg	멁
meolm	멂
meolb	멃
meols	멄
meolt	멅
meolp	멆
meolh	멇
meom	멈
meob	멉
meobs	멊
meos	멋
meoss	멌
meong	멍
meoj	멎
meoc	멏
meok	멐
meot	멑
meop	멒
meoh	멓
me	메
meg	멕
megg	멖
megs	멗
men	멘
menj	멙
menh	멚
med	멛
mel	멜
melg	멝
melm	멞
melb	멟
mels	멠
melt	멡
melp	멢
melh	멣
mem	멤
meb	멥
mebs	멦
mes	멧
mess	멨
meng	멩
mej	멪
mec	멫
mek	멬
met	멭
mep	멮
meh	멯
myeo	며
myeog	멱
myeogg	멲
myeogs	멳
myeon	면
myeonj	멵
myeonh	멶
myeod	멷
myeol	멸
myeolg	멹
myeolm	멺
myeolb	멻
myeols	멼
myeolt	멽
myeolp	멾
myeolh	멿
myeom	몀
myeob	몁
myeobs	몂
myeos	몃
myeoss	몄
myeong	명
myeoj	몆
myeoc	몇
myeok	몈
myeot	몉
myeop	몊
myeoh	몋
mye	몌
myeg	몍
myegg	몎
myegs	몏
myen	몐
myenj	몑
myenh	몒
myed	몓
myel	몔
myelg	몕
myelm	몖
myelb	몗
myels	몘
myelt	몙
myelp	몚
myelh	몛
myem	몜
myeb	몝
myebs	몞
myes	몟
myess	몠
myeng	몡
myej	몢
myec	몣
myek	몤
myet	몥
myep	몦
myeh	몧
mo	모
mog	목
mogg	몪
mogs	몫
mon	몬
monj	몭
monh	몮
mod	몯
mol	몰
molg	몱
molm	몲
molb	몳
mols	몴
molt	몵
molp	몶
molh	몷
mom	몸
mob	몹
mobs	몺
mos	못
moss	몼
mong	몽
moj	몾
moc	몿
mok	뫀
mot	뫁
mop	뫂
moh	뫃
mwa	뫄
mwag	뫅
mwagg	뫆
mwags	뫇
mwan	뫈
mwanj	뫉
mwanh	뫊
mwad	뫋
mwal	뫌
mwalg	뫍
mwalm	뫎
mwalb	뫏
mwals	뫐
mwalt	뫑
mwalp	뫒
mwalh	뫓
mwam	뫔
mwab	뫕
mwabs	뫖
mwas	뫗
mwass	뫘
mwang	뫙
mwaj	뫚
mwac	뫛
mwak	뫜
mwat	뫝
mwap	뫞
mwah	뫟
mwae	뫠
mwaeg	뫡
mwaegg	뫢
mwaegs	뫣
mwaen	뫤
mwaenj	뫥
mwaenh	뫦
mwaed	뫧
mwael	뫨
mwaelg	뫩
mwaelm	뫪
mwaelb	뫫
mwaels	뫬
mwaelt	뫭
mwaelp	뫮
mwaelh	뫯
mwaem	뫰
mwaeb	뫱
mwaebs	뫲
mwaes	뫳
mwaess	뫴
mwaeng	뫵
mwaej	뫶
mwaec	뫷
mwaek	뫸
mwaet	뫹
mwaep	뫺
mwaeh	뫻
moe	뫼
moeg	뫽
moegg	뫾
moegs	뫿
moen	묀
moenj	묁
moenh	묂
moed	묃
moel	묄
moelg	묅
moelm	묆
moelb	묇
moels	묈
moelt	묉
moelp	묊
moelh	묋
moem	묌
moeb	묍
moebs	묎
moes	묏
moess	묐
moeng	묑
moej	묒
moec	묓
moek	묔
moet	묕
moep	묖
moeh	묗
myo	묘
myog	묙
myogg	묚
myogs	묛
myon	묜
myonj	묝
myonh	묞
myod	묟
myol	묠
myolg	묡
myolm	묢
myolb	묣
myols	묤
myolt	묥
myolp	묦
myolh	묧
myom	묨
myob	묩
myobs	묪
myos	묫
myoss	묬
myong	묭
myoj	묮
myoc	묯
myok	묰
myot	묱
myop	묲
myoh	묳
mu	무
mug	묵
mugg	묶
mugs	묷
mun	문
munj	묹
munh	묺
mud	묻
mul	물
mulg	묽
mulm	묾
mulb	묿
muls	뭀
mult	뭁
mulp	뭂
mulh	뭃
mum	뭄
mub	뭅
mubs	뭆
mus	뭇
muss	뭈
mung	뭉
muj	뭊
muc	뭋
muk	뭌
mut	뭍
mup	뭎
muh	뭏
mweo	뭐
mweog	뭑
mweogg	뭒
mweogs	뭓
mweon	뭔
mweonj	뭕
mweonh	뭖
mweod	뭗
mweol	뭘
mweolg	뭙
mweolm	뭚
mweolb	뭛
mweols	뭜
mweolt	뭝
mweolp	뭞
mweolh	뭟
mweom	뭠
mweob	뭡
mweobs	뭢
mweos	뭣
mweoss	뭤
mweong	뭥
mweoj	뭦
mweoc	뭧
mweok	뭨
mweot	뭩
mweop	뭪
mweoh	뭫
mwe	뭬
mweg	뭭
mwegg	뭮
mwegs	뭯
mwen	뭰
mwenj	뭱
mwenh	뭲
mwed	뭳
mwel	뭴
mwelg	뭵
mwelm	뭶
mwelb	뭷
mwels	뭸
mwelt	뭹
mwelp	뭺
mwelh	뭻
mwem	뭼
mweb	뭽
mwebs	뭾
mwes	뭿
mwess	뮀
mweng	뮁
mwej	뮂
mwec	뮃
mwek	뮄
mwet	뮅
mwep	뮆
mweh	뮇
mwi	뮈
mwig	뮉
mwigg	뮊
mwigs	뮋
mwin	뮌
mwinj	뮍
mwinh	뮎
mwid	뮏
mwil	뮐
mwilg	뮑
mwilm	뮒
mwilb	뮓
mwils	뮔
mwilt	뮕
mwilp	뮖
mwilh	뮗
mwim	뮘
mwib	뮙
mwibs	뮚
mwis	뮛
mwiss	뮜
mwing	뮝
mwij	뮞
mwic	뮟
mwik	뮠
mwit	뮡
mwip	뮢
mwih	뮣
myu	뮤
myug	뮥
myugg	뮦
myugs	뮧
myun	뮨
myunj	뮩
myunh	뮪
myud	뮫
myul	뮬
myulg	뮭
myulm	뮮
myulb	뮯
myuls	뮰
myult	뮱
myulp	뮲
myulh	뮳
myum	뮴
myub	뮵
myubs	뮶
myus	뮷
myuss	뮸
myung	뮹
myuj	뮺
myuc	뮻
myuk	뮼
myut	뮽
myup	뮾
myuh	뮿
meu	므
meug	믁
meugg	믂
meugs	믃
meun	믄
meunj	믅
meunh	믆
meud	믇
meul	믈
meulg	믉
meulm	믊
meulb	믋
meuls	믌
meult	믍
meulp	믎
meulh	믏
meum	믐
meub	믑
meubs	믒
meus	믓
meuss	믔
meung	믕
meuj	믖
meuc	믗
meuk	믘
meut	믙
meup	믚
meuh	믛
myi	믜
myig	믝
myigg	믞
myigs	믟
myin	믠
myinj	믡
myinh	믢
myid	믣
myil	믤
myilg	믥
myilm	믦
myilb	믧
myils	믨
myilt	믩
myilp	믪
myilh	믫
myim	믬
myib	믭
myibs	믮
myis	믯
myiss	믰
mying	믱
myij	믲
myic	믳
myik	믴
myit	믵
myip	믶
myih	믷
mi	미
mig	믹
migg	믺
migs	믻
min	민
minj	믽
minh	믾
mid	믿
mil	밀
milg	밁
milm	밂
milb	밃
mils	밄
milt	밅
milp	밆
milh	밇
mim	밈
mib	밉
mibs	밊
mis	밋
miss	밌
ming	밍
mij	밎
mic	및
mik	밐
mit	밑
mip	밒
mih	밓
ba	바
bag	박
bagg	밖
bags	밗
ban	반
banj	밙
banh	밚
bad	받
bal	발
balg	밝
balm	밞
balb	밟
bals	밠
balt	밡
balp	밢
balh	밣
bam	밤
bab	밥
babs	밦
bas	밧
bass	밨
bang	방
baj	밪
bac	밫
bak	밬
bat	밭
bap	밮
bah	밯
bae	배
baeg	백
baegg	밲
baegs	밳
baen	밴
baenj	밵
baenh	밶
baed	밷
bael	밸
baelg	밹
baelm	밺
baelb	밻
baels	밼
baelt	밽
baelp	밾
baelh	밿
baem	뱀
baeb	뱁
baebs	뱂
baes	뱃
baess	뱄
baeng	뱅
baej	뱆
baec	뱇
baek	뱈
baet	뱉
baep	뱊
baeh	뱋
bya	뱌
byag	뱍
byagg	뱎
byags	뱏
byan	뱐
byanj	뱑
byanh	뱒
byad	뱓
byal	뱔
byalg	뱕
byalm	뱖
byalb	뱗
byals	뱘
byalt	뱙
byalp	뱚
byalh	뱛
byam	뱜
byab	뱝
byabs	뱞
byas	뱟
byass	뱠
byang	뱡
byaj	뱢
byac	뱣
byak	뱤
byat	뱥
byap	뱦
byah	뱧
byae	뱨
byaeg	뱩
byaegg	뱪
byaegs	뱫
byaen	뱬
byaenj	뱭
byaenh	뱮
byaed	뱯
byael	뱰
byaelg	뱱
byaelm	뱲
byaelb	뱳
byaels	뱴
byaelt	뱵
byaelp	뱶
byaelh	뱷
byaem	뱸
byaeb	뱹
byaebs	뱺
byaes	뱻
byaess	뱼
byaeng	뱽
byaej	뱾
byaec	뱿
byaek	벀
byaet	벁
byaep	벂
byaeh	벃
beo	버
beog	벅
beogg	벆
beogs	벇
beon	번
beonj	벉
beonh	벊
beod	벋
beol	벌
beolg	벍
beolm	벎
beolb	벏
beols	벐
beolt	벑
beolp	벒
beolh	벓
beom	범
beob	법
beobs	벖
beos	벗
beoss	벘
beong	벙
beoj	벚
beoc	벛
beok	벜
beot	벝
beop	벞
beoh	벟
be	베
beg	벡
begg	벢
begs	벣
ben	벤
benj	벥
benh	벦
bed	벧
bel	벨
belg	벩
belm	벪
belb	벫
bels	벬
belt	벭
belp	벮
belh	벯
bem	벰
beb	벱
bebs	벲
bes	벳
bess	벴
beng	벵
bej	벶
bec	벷
bek	벸
bet	벹
bep	벺
beh	벻
byeo	벼
byeog	벽
byeogg	벾
byeogs	벿
byeon	변
byeonj	볁
byeonh	볂
byeod	볃
byeol	별
byeolg	볅
byeolm	볆
byeolb	볇
byeols	볈
byeolt	볉
byeolp	볊
byeolh	볋
byeom	볌
byeob	볍
byeobs	볎
byeos	볏
byeoss	볐
byeong	병
byeoj	볒
byeoc	볓
byeok	볔
byeot	볕
byeop	볖
byeoh	볗
bye	볘
byeg	볙
byegg	볚
byegs	볛
byen	볜
byenj	볝
byenh	볞
byed	볟
byel	볠
byelg	볡
byelm	볢
byelb	볣
byels	볤
byelt	볥
byelp	볦
byelh	볧
byem	볨
byeb	볩
byebs	볪
byes	볫
byess	볬
byeng	볭
byej	볮
byec	볯
byek	볰
byet	볱
byep	볲
byeh	볳
bo	보
bog	복
bogg	볶
bogs	볷
bon	본
bonj	볹
bonh	볺
bod	볻
bol	볼
bolg	볽
bolm	볾
bolb	볿
bols	봀
bolt	봁
bolp	봂
bolh	봃
bom	봄
bob	봅
bobs	봆
bos	봇
boss	봈
bong	봉
boj	봊
boc	봋
bok	봌
bot	봍
bop	봎
boh	봏
bwa	봐
bwag	봑
bwagg	봒
bwags	봓
bwan	봔
bwanj	봕
bwanh	봖
bwad	봗
bwal	봘
bwalg	봙
bwalm	봚
bwalb	봛
bwals	봜
bwalt	봝
bwalp	봞
bwalh	봟
bwam	봠
bwab	봡
bwabs	봢
bwas	봣
bwass	봤
bwang	봥
bwaj	봦
bwac	봧
bwak	봨
bwat	봩
bwap	봪
bwah	봫
bwae	봬
bwaeg	봭
bwaegg	봮
bwaegs	봯
bwaen	봰
bwaenj	봱
bwaenh	봲
bwaed	봳
bwael	봴
bwaelg	봵
bwaelm	봶
bwaelb	봷
bwaels	봸
bwaelt	봹
bwaelp	봺
bwaelh	봻
bwaem	봼
bwaeb	봽
bwaebs	봾
bwaes	봿
bwaess	뵀
bwaeng	뵁
bwaej	뵂
bwaec	뵃
bwaek	뵄
bwaet	뵅
bwaep	뵆
bwaeh	뵇
boe	뵈
boeg	뵉
boegg	뵊
boegs	뵋
boen	뵌
boenj	뵍
boenh	뵎
boed	뵏
boel	뵐
boelg	뵑
boelm	뵒
boelb	뵓
boels	뵔
boelt	뵕
boelp	뵖
boelh	뵗
boem	뵘
boeb	뵙
boebs	뵚
boes	뵛
boess	뵜
boeng	뵝
boej	뵞
boec	뵟
boek	뵠
boet	뵡
boep	뵢
boeh	뵣
byo	뵤
byog	뵥
byogg	뵦
byogs	뵧
byon	뵨
byonj	뵩
byonh	뵪
byod	뵫
byol	뵬
byolg	뵭
byolm	뵮
byolb	뵯
byols	뵰
byolt	뵱
byolp	뵲
byolh	뵳
byom	뵴
byob	뵵
byobs	뵶
byos	뵷
byoss	뵸
byong	뵹
byoj	뵺
byoc	뵻
byok	뵼
byot	뵽
byop	뵾
byoh	뵿
bu	부
bug	북
bugg	붂
bugs	붃
bun	분
bunj	붅
bunh	붆
bud	붇
bul	불
bulg	붉
bulm	붊
bulb	붋
buls	붌
bult	붍
bulp	붎
bulh	붏
bum	붐
bub	붑
bubs	붒
bus	붓
buss	붔
bung	붕
buj	붖
buc	붗
buk	붘
but	붙
bup	붚
buh	붛
bweo	붜
bweog	붝
bweogg	붞
bweogs	붟
bweon	붠
bweonj	붡
bweonh	붢
bweod	붣
bweol	붤
bweolg	붥
bweolm	붦
bweolb	붧
bweols	붨
bweolt	붩
bweolp	붪
bweolh	붫
bweom	붬
bweob	붭
bweobs	붮
bweos	붯
bweoss	붰
bweong	붱
bweoj	붲
bweoc	붳
bweok	붴
bweot	붵
bweop	붶
bweoh	붷
bwe	붸
bweg	붹
bwegg	붺
bwegs	붻
bwen	붼
bwenj	붽
bwenh	붾
bwed	붿
bwel	뷀
bwelg	뷁
bwelm	뷂
bwelb	뷃
bwels	뷄
bwelt	뷅
bwelp	뷆
bwelh	뷇
bwem	뷈
bweb	뷉
bwebs	뷊
bwes	뷋
bwess	뷌
bweng	뷍
bwej	뷎
bwec	뷏
bwek	뷐
bwet	뷑
bwep	뷒
bweh	뷓
bwi	뷔
bwig	뷕
bwigg	뷖
bwigs	뷗
bwin	뷘
bwinj	뷙
bwinh	뷚
bwid	뷛
bwil	뷜
bwilg	뷝
bwilm	뷞
bwilb	뷟
bwils	뷠
bwilt	뷡
bwilp	뷢
bwilh	뷣
bwim	뷤
bwib	뷥
bwibs	뷦
bwis	뷧
bwiss	뷨
bwing	뷩
bwij	뷪
bwic	뷫
bwik	뷬
bwit	뷭
bwip	뷮
bwih	뷯
byu	뷰
byug	뷱
byugg	뷲
byugs	뷳
byun	뷴
byunj	뷵
byunh	뷶
byud	뷷
byul	뷸
byulg	뷹
byulm	뷺
byulb	뷻
byuls	뷼
byult	뷽
byulp	뷾
byulh	뷿
byum	븀
byub	븁
byubs	븂
byus	븃
byuss	븄
byung	븅
byuj	븆
byuc	븇
byuk	븈
byut	븉
byup	븊
byuh	븋
beu	브
beug	븍
beugg	븎
beugs	븏
beun	븐
beunj	븑
beunh	븒
beud	븓
beul	블
beulg	븕
beulm	븖
beulb	븗
beuls	븘
beult	븙
beulp	븚
beulh	븛
beum	븜
beub	븝
beubs	븞
beus	븟
beuss	븠
beung	븡
beuj	븢
beuc	븣
beuk	븤
beut	븥
beup	븦
beuh	븧
byi	븨
byig	븩
byigg	븪
byigs	븫
byin	븬
byinj	븭
byinh	븮
byid	븯
byil	븰
byilg	븱
byilm	븲
byilb	븳
byils	븴
byilt	븵
byilp	븶
byilh	븷
byim	븸
byib	븹
byibs	븺
byis	븻
byiss	븼
bying	븽
byij	븾
byic	븿
byik	빀
byit	빁
byip	빂
byih	빃
bi	비
big	빅
bigg	빆
bigs	빇
bin	빈
binj	빉
binh	빊
bid	빋
bil	빌
bilg	빍
bilm	빎
bilb	빏
bils	빐
bilt	빑
bilp	빒
bilh	빓
bim	빔
bib	빕
bibs	빖
bis	빗
biss	빘
bing	빙
bij	빚
bic	빛
bik	빜
bit	빝
bip	빞
bih	빟
bba	빠
bbag	빡
bbagg	빢
bbags	빣
bban	빤
bbanj	빥
bbanh	빦
bbad	빧
bbal	빨
bbalg	빩
bbalm	빪
bbalb	빫
bbals	빬
bbalt	빭
bbalp	빮
bbalh	빯
bbam	빰
bbab	빱
bbabs	빲
bbas	빳
bbass	빴
bbang	빵
bbaj	빶
bbac	빷
bbak	빸
bbat	빹
bbap	빺
bbah	빻
bbae	빼
bbaeg	빽
bbaegg	빾
bbaegs	빿
bbaen	뺀
bbaenj	뺁
bbaenh	뺂
bbaed	뺃
bbael	뺄
bbaelg	뺅
bbaelm	뺆
bbaelb	뺇
bbaels	뺈
bbaelt	뺉
bbaelp	뺊
bbaelh	뺋
bbaem	뺌
bbaeb	뺍
bbaebs	뺎
bbaes	뺏
bbaess	뺐
bbaeng	뺑
bbaej	뺒
bbaec	뺓
bbaek	뺔
bbaet	뺕
bbaep	뺖
bbaeh	뺗
bbya	뺘
bbyag	뺙
bbyagg	뺚
bbyags	뺛
bbyan	뺜
bbyanj	뺝
bbyanh	뺞
bbyad	뺟
bbyal	뺠
bbyalg	뺡
bbyalm	뺢
bbyalb	뺣
bbyals	뺤
bbyalt	뺥
bbyalp	뺦
bbyalh	뺧
bbyam	뺨
bbyab	뺩
bbyabs	뺪
bbyas	뺫
bbyass	뺬
bbyang	뺭
bbyaj	뺮
bbyac	뺯
bbyak	뺰
bbyat	뺱
bbyap	뺲
bbyah	뺳
bbyae	뺴
bbyaeg	뺵
bbyaegg	뺶
bbyaegs	뺷
bbyaen	뺸
bbyaenj	뺹
bbyaenh	뺺
bbyaed	뺻
bbyael	뺼
bbyaelg	뺽
bbyaelm	뺾
bbyaelb	뺿
bbyaels	뻀
bbyaelt	뻁
bbyaelp	뻂
bbyaelh	뻃
bbyaem	뻄
bbyaeb	뻅
bbyaebs	뻆
bbyaes	뻇
bbyaess	뻈
bbyaeng	뻉
bbyaej	뻊
bbyaec	뻋
bbyaek	뻌
bbyaet	뻍
bbyaep	뻎
bbyaeh	뻏
bbeo	뻐
bbeog	뻑
bbeogg	뻒
bbeogs	뻓
bbeon	뻔
bbeonj	뻕
bbeonh	뻖
bbeod	뻗
bbeol	뻘
bbeolg	뻙
bbeolm	뻚
bbeolb	뻛
bbeols	뻜
bbeolt	뻝
bbeolp	뻞
bbeolh	뻟
bbeom	뻠
bbeob	뻡
bbeobs	뻢
bbeos	뻣
bbeoss	뻤
bbeong	뻥
bbeoj	뻦
bbeoc	뻧
bbeok	뻨
bbeot	뻩
bbeop	뻪
bbeoh	뻫
bbe	뻬
bbeg	뻭
bbegg	뻮
bbegs	뻯
bben	뻰
bbenj	뻱
bbenh	뻲
bbed	뻳
bbel	뻴
bbelg	뻵
bbelm	뻶
bbelb	뻷
bbels	뻸
bbelt	뻹
bbelp	뻺
bbelh	뻻
bbem	뻼
bbeb	뻽
bbebs	뻾
bbes	뻿
bbess	뼀
bbeng	뼁
bbej	뼂
bbec	뼃
bbek	뼄
bbet	뼅
bbep	뼆
bbeh	뼇
bbyeo	뼈
bbyeog	뼉
bbyeogg	뼊
bbyeogs	뼋
bbyeon	뼌
bbyeonj	뼍
bbyeonh	뼎
bbyeod	뼏
bbyeol	뼐
bbyeolg	뼑
bbyeolm	뼒
bbyeolb	뼓
bbyeols	뼔
bbyeolt	뼕
bbyeolp	뼖
bbyeolh	뼗
bbyeom	뼘
bbyeob	뼙
bbyeobs	뼚
bbyeos	뼛
bbyeoss	뼜
bbyeong	뼝
bbyeoj	뼞
bbyeoc	뼟
bbyeok	뼠
bbyeot	뼡
bbyeop	뼢
bbyeoh	뼣
bbye	뼤
bbyeg	뼥
bbyegg	뼦
bbyegs	뼧
bbyen	뼨
bbyenj	뼩
bbyenh	뼪
bbyed	뼫
bbyel	뼬
bbyelg	뼭
bbyelm	뼮
bbyelb	뼯
bbyels	뼰
bbyelt	뼱
bbyelp	뼲
bbyelh	뼳
bbyem	뼴
bbyeb	뼵
bbyebs	뼶
bbyes	뼷
bbyess	뼸
bbyeng	뼹
bbyej	뼺
bbyec	뼻
bbyek	뼼
bbyet	뼽
bbyep	뼾
bbyeh	뼿
bbo	뽀
bbog	뽁
bbogg	뽂
bbogs	뽃
bbon	뽄
bbonj	뽅
bbonh	뽆
bbod	뽇
bbol	뽈
bbolg	뽉
bbolm	뽊
bbolb	뽋
bbols	뽌
bbolt	뽍
bbolp	뽎
bbolh	뽏
bbom	뽐
bbob	뽑
bbobs	뽒
bbos	뽓
bboss	뽔
bbong	뽕
bboj	뽖
bboc	뽗
bbok	뽘
bbot	뽙
bbop	뽚
bboh	뽛
bbwa	뽜
bbwag	뽝
bbwagg	뽞
bbwags	뽟
bbwan	뽠
bbwanj	뽡
bbwanh	뽢
bbwad	뽣
bbwal	뽤
bbwalg	뽥
bbwalm	뽦
bbwalb	뽧
bbwals	뽨
bbwalt	뽩
bbwalp	뽪
bbwalh	뽫
bbwam	뽬
bbwab	뽭
bbwabs	뽮
bbwas	뽯
bbwass	뽰
bbwang	뽱
bbwaj	뽲
bbwac	뽳
bbwak	뽴
bbwat	뽵
bbwap	뽶
bbwah	뽷
bbwae	뽸
bbwaeg	뽹
bbwaegg	뽺
bbwaegs	뽻
bbwaen	뽼
bbwaenj	뽽
bbwaenh	뽾
bbwaed	뽿
bbwael	뾀
bbwaelg	뾁
bbwaelm	뾂
bbwaelb	뾃
bbwaels	뾄
bbwaelt	뾅
bbwaelp	뾆
bbwaelh	뾇
bbwaem	뾈
bbwaeb	뾉
bbwaebs	뾊
bbwaes	뾋
bbwaess	뾌
bbwaeng	뾍
bbwaej	뾎
bbwaec	뾏
bbwaek	뾐
bbwaet	뾑
bbwaep	뾒
bbwaeh	뾓
bboe	뾔
bboeg	뾕
bboegg	뾖
bboegs	뾗
bboen	뾘
bboenj	뾙
bboenh	뾚
bboed	뾛
bboel	뾜
bboelg	뾝
bboelm	뾞
bboelb	뾟
bboels	뾠
bboelt	뾡
bboelp	뾢
bboelh	뾣
bboem	뾤
bboeb	뾥
bboebs	뾦
bboes	뾧
bboess	뾨
bboeng	뾩
bboej	뾪
bboec	뾫
bboek	뾬
bboet	뾭
bboep	뾮
bboeh	뾯
bbyo	뾰
bbyog	뾱
bbyogg	뾲
bbyogs	뾳
bbyon	뾴
bbyonj	뾵
bbyonh	뾶
bbyod	뾷
bbyol	뾸
bbyolg	뾹
bbyolm	뾺
bbyolb	뾻
bbyols	뾼
bbyolt	뾽
bbyolp	뾾
bbyolh	뾿
bbyom	뿀
bbyob	뿁
bbyobs	뿂
bbyos	뿃
bbyoss	뿄
bbyong	뿅
bbyoj	뿆
bbyoc	뿇
bbyok	뿈
bbyot	뿉
bbyop	뿊
bbyoh	뿋
bbu	뿌
bbug	뿍
bbugg	뿎
bbugs	뿏
bbun	뿐
bbunj	뿑
bbunh	뿒
bbud	뿓
bbul	뿔
bbulg	뿕
bbulm	뿖
bbulb	뿗
bbuls	뿘
bbult	뿙
bbulp	뿚
bbulh	뿛
bbum	뿜
bbub	뿝
bbubs	뿞
bbus	뿟
bbuss	뿠
bbung	뿡
bbuj	뿢
bbuc	뿣
bbuk	뿤
bbut	뿥
bbup	뿦
bbuh	뿧
bbweo	뿨
bbweog	뿩
bbweogg	뿪
bbweogs	뿫
bbweon	뿬
bbweonj	뿭
bbweonh	뿮
bbweod	뿯
bbweol	뿰
bbweolg	뿱
bbweolm	뿲
bbweolb	뿳
bbweols	뿴
bbweolt	뿵
bbweolp	뿶
bbweolh	뿷
bbweom	뿸
bbweob	뿹
bbweobs	뿺
bbweos	뿻
bbweoss	뿼
bbweong	뿽
bbweoj	뿾
bbweoc	뿿
bbweok	쀀
bbweot	쀁
bbweop	쀂
bbweoh	쀃
bbwe	쀄
bbweg	쀅
bbwegg	쀆
bbwegs	쀇
bbwen	쀈
bbwenj	쀉
bbwenh	쀊
bbwed	쀋
bbwel	쀌
bbwelg	쀍
bbwelm	쀎
bbwelb	쀏
bbwels	쀐
bbwelt	쀑
bbwelp	쀒
bbwelh	쀓
bbwem	쀔
bbweb	쀕
bbwebs	쀖
bbwes	쀗
bbwess	쀘
bbweng	쀙
bbwej	쀚
bbwec	쀛
bbwek	쀜
bbwet	쀝
bbwep	쀞
bbweh	쀟
bbwi	쀠
bbwig	쀡
bbwigg	쀢
bbwigs	쀣
bbwin	쀤
bbwinj	쀥
bbwinh	쀦
bbwid	쀧
bbwil	쀨
bbwilg	쀩
bbwilm	쀪
bbwilb	쀫
bbwils	쀬
bbwilt	쀭
bbwilp	쀮
bbwilh	쀯
bbwim	쀰
bbwib	쀱
bbwibs	쀲
bbwis	쀳
bbwiss	쀴
bbwing	쀵
bbwij	쀶
bbwic	쀷
bbwik	쀸
bbwit	쀹
bbwip	쀺
bbwih	쀻
bbyu	쀼
bbyug	쀽
bbyugg	쀾
bbyugs	쀿
bbyun	쁀
bbyunj	쁁
bbyunh	쁂
bbyud	쁃
bbyul	쁄
bbyulg	쁅
bbyulm	쁆
bbyulb	쁇
bbyuls	쁈
bbyult	쁉
bbyulp	쁊
bbyulh	쁋
bbyum	쁌
bbyub	쁍
bbyubs	쁎
bbyus	쁏
bbyuss	쁐
bbyung	쁑
bbyuj	쁒
bbyuc	쁓
bbyuk	쁔
bbyut	쁕
bbyup	쁖
bbyuh	쁗
bbeu	쁘
bbeug	쁙
bbeugg	쁚
bbeugs	쁛
bbeun	쁜
bbeunj	쁝
bbeunh	쁞
bbeud	쁟
bbeul	쁠
bbeulg	쁡
bbeulm	쁢
bbeulb	쁣
bbeuls	쁤
bbeult	쁥
bbeulp	쁦
bbeulh	쁧
bbeum	쁨
bbeub	쁩
bbeubs	쁪
bbeus	쁫
bbeuss	쁬
bbeung	쁭
bbeuj	쁮
bbeuc	쁯
bbeuk	쁰
bbeut	쁱
bbeup	쁲
bbeuh	쁳
bbyi	쁴
bbyig	쁵
bbyigg	쁶
bbyigs	쁷
bbyin	쁸
bbyinj	쁹
bbyinh	쁺
bbyid	쁻
bbyil	쁼
bbyilg	쁽
bbyilm	쁾
bbyilb	쁿
bbyils	삀
bbyilt	삁
bbyilp	삂
bbyilh	삃
bbyim	삄
bbyib	삅
bbyibs	삆
bbyis	삇
bbyiss	삈
bbying	삉
bbyij	삊
bbyic	삋
bbyik	삌
bbyit	삍
bbyip	삎
bbyih	삏
bbi	삐
bbig	삑
bbigg	삒
bbigs	삓
bbin	삔
bbinj	삕
bbinh	삖
bbid	삗
bbil	삘
bbilg	삙
bbilm	삚
bbilb	삛
bbils	삜
bbilt	삝
bbilp	삞
bbilh	삟
bbim	삠
bbib	삡
bbibs	삢
bbis	삣
bbiss	삤
bbing	삥
bbij	삦
bbic	삧
bbik	삨
bbit	삩
bbip	삪
bbih	삫
sa	사
sag	삭
sagg	삮
sags	삯
san	산
sanj	삱
sanh	삲
sad	삳
sal	살
salg	삵
salm	삶
salb	삷
sals	삸
salt	삹
salp	삺
salh	삻
sam	삼
sab	삽
sabs	삾
sas	삿
sass	샀
sang	상
saj	샂
sac	샃
sak	샄
sat	샅
sap	샆
sah	샇
sae	새
saeg	색
saegg	샊
saegs	샋
saen	샌
saenj	샍
saenh	샎
saed	샏
sael	샐
saelg	샑
saelm	샒
saelb	샓
saels	샔
saelt	샕
saelp	샖
saelh	샗
saem	샘
saeb	샙
saebs	샚
saes	샛
saess	샜
saeng	생
saej	샞
saec	샟
saek	샠
saet	샡
saep	샢
saeh	샣
sya	샤
syag	샥
syagg	샦
syags	샧
syan	샨
syanj	샩
syanh	샪
syad	샫
syal	샬
syalg	샭
syalm	샮
syalb	샯
syals	샰
syalt	샱
syalp	샲
syalh	샳
syam	샴
syab	샵
syabs	샶
syas	샷
syass	샸
syang	샹
syaj	샺
syac	샻
syak	샼
syat	샽
syap	샾
syah	샿
syae	섀
syaeg	섁
syaegg	섂
syaegs	섃
syaen	섄
syaenj	섅
syaenh	섆
syaed	섇
syael	섈
syaelg	섉
syaelm	섊
syaelb	섋
syaels	섌
syaelt	섍
syaelp	섎
syaelh	섏
syaem	섐
syaeb	섑
syaebs	섒
syaes	섓
syaess	섔
syaeng	섕
syaej	섖
syaec	섗
syaek	섘
syaet	섙
syaep	섚
syaeh	섛
seo	서
seog	석
seogg	섞
seogs	섟
seon	선
seonj	섡
seonh	섢
seod	섣
seol	설
seolg	섥
seolm	섦
seolb	섧
seols	섨
seolt	섩
seolp	섪
seolh	섫
seom	섬
seob	섭
seobs	섮
seos	섯
seoss	섰
seong	성
seoj	섲
seoc	섳
seok	섴
seot	섵
seop	섶
seoh	섷
se	세
seg	섹
segg	섺
segs	섻
sen	센
senj	섽
senh	섾
sed	섿
sel	셀
selg	셁
selm	셂
selb	셃
sels	셄
selt	셅
selp	셆
selh	셇
sem	셈
seb	셉
sebs	셊
ses	셋
sess	셌
seng	셍
sej	셎
sec	셏
sek	셐
set	셑
sep	셒
seh	셓
syeo	셔
syeog	셕
syeogg	셖
syeogs	셗
syeon	션
syeonj	셙
syeonh	셚
syeod	셛
syeol	셜
syeolg	셝
syeolm	셞
syeolb	셟
syeols	셠
syeolt	셡
syeolp	셢
syeolh	셣
syeom	셤
syeob	셥
syeobs	셦
syeos	셧
syeoss	셨
syeong	셩
syeoj	셪
syeoc	셫
syeok	셬
syeot	셭
syeop	셮
syeoh	셯
sye	셰
syeg	셱
syegg	셲
syegs	셳
syen	셴
syenj	셵
syenh	셶
syed	셷
syel	셸
syelg	셹
syelm	셺
syelb	셻
syels	셼
syelt	셽
syelp	셾
syelh	셿
syem	솀
syeb	솁
syebs	솂
syes	솃
syess	솄
syeng	솅
syej	솆
syec	솇
syek	솈
syet	솉
syep	솊
syeh	솋
so	소
sog	속
sogg	솎
sogs	솏
son	손
sonj	솑
sonh	솒
sod	솓
sol	솔
solg	솕
solm	솖
solb	솗
sols	솘
solt	솙
solp	솚
solh	솛
som	솜
sob	솝
sobs	솞
sos	솟
soss	솠
song	송
soj	솢
soc	솣
sok	솤
sot	솥
sop	솦
soh	솧
swa	솨
swag	솩
swagg	솪
swags	솫
swan	솬
swanj	솭
swanh	솮
swad	솯
swal	솰
swalg	솱
swalm	솲
swalb	솳
swals	솴
swalt	솵
swalp	솶
swalh	솷
swam	솸
swab	솹
swabs	솺
swas	솻
swass	솼
swang	솽
swaj	솾
swac	솿
swak	쇀
swat	쇁
swap	쇂
swah	쇃
swae	쇄
swaeg	쇅
swaegg	쇆
swaegs	쇇
swaen	쇈
swaenj	쇉
swaenh	쇊
swaed	쇋
swael	쇌
swaelg	쇍
swaelm	쇎
swaelb	쇏
swaels	쇐
swaelt	쇑
swaelp	쇒
swaelh	쇓
swaem	쇔
swaeb	쇕
swaebs	쇖
swaes	쇗
swaess	쇘
swaeng	쇙
swaej	쇚
swaec	쇛
swaek	쇜
swaet	쇝
swaep	쇞
swaeh	쇟
soe	쇠
soeg	쇡
soegg	쇢
soegs	쇣
soen	쇤
soenj	쇥
soenh	쇦
soed	쇧
soel	쇨
soelg	쇩
soelm	쇪
soelb	쇫
soels	쇬
soelt	쇭
soelp	쇮
soelh	쇯
soem	쇰
soeb	쇱
soebs	쇲
soes	쇳
soess	쇴
soeng	쇵
soej	쇶
soec	쇷
soek	쇸
soet	쇹
soep	쇺
soeh	쇻
syo	쇼
syog	쇽
syogg	쇾
syogs	쇿
syon	숀
syonj	숁
syonh	숂
syod	숃
syol	숄
syolg	숅
syolm	숆
syolb	숇
syols	숈
syolt	숉
syolp	숊
syolh	숋
syom	숌
syob	숍
syobs	숎
syos	숏
syoss	숐
syong	숑
syoj	숒
syoc	숓
syok	숔
syot	숕
syop	숖
syoh	숗
su	수
sug	숙
sugg	숚
sugs	숛
sun	순
sunj	숝
sunh	숞
sud	숟
sul	술
sulg	숡
sulm	숢
sulb	숣
suls	숤
sult	숥
sulp	숦
sulh	숧
sum	숨
sub	숩
subs	숪
sus	숫
suss	숬
sung	숭
suj	숮
suc	숯
suk	숰
sut	숱
sup	숲
suh	숳
sweo	숴
sweog	숵
sweogg	숶
sweogs	숷
sweon	숸
sweonj	숹
sweonh	숺
sweod	숻
sweol	숼
sweolg	숽
sweolm	숾
sweolb	숿
sweols	쉀
sweolt	쉁
sweolp	쉂
sweolh	쉃
sweom	쉄
sweob	쉅
sweobs	쉆
sweos	쉇
sweoss	쉈
sweong	쉉
sweoj	쉊
sweoc	쉋
sweok	쉌
sweot	쉍
sweop	쉎
sweoh	쉏
swe	쉐
sweg	쉑
swegg	쉒
swegs	쉓
swen	쉔
swenj	쉕
swenh	쉖
swed	쉗
swel	쉘
swelg	쉙
swelm	쉚
swelb	쉛
swels	쉜
swelt	쉝
swelp	쉞
swelh	쉟
swem	쉠
sweb	쉡
swebs	쉢
swes	쉣
swess	쉤
sweng	쉥
swej	쉦
swec	쉧
swek	쉨
swet	쉩
swep	쉪
sweh	쉫
swi	쉬
swig	쉭
swigg	쉮
swigs	쉯
swin	쉰
swinj	쉱
swinh	쉲
swid	쉳
swil	쉴
swilg	쉵
swilm	쉶
swilb	쉷
swils	쉸
swilt	쉹
swilp	쉺
swilh	쉻
swim	쉼
swib	쉽
swibs	쉾
swis	쉿
swiss	슀
swing	슁
swij	슂
swic	슃
swik	슄
swit	슅
swip	슆
swih	슇
syu	슈
syug	슉
syugg	슊
syugs	슋
syun	슌
syunj	슍
syunh	슎
syud	슏
syul	슐
syulg	슑
syulm	슒
syulb	슓
syuls	슔
syult	슕
syulp	슖
syulh	슗
syum	슘
syub	슙
syubs	슚
syus	슛
syuss	슜
syung	슝
syuj	슞
syuc	슟
syuk	슠
syut	슡
syup	슢
syuh	슣
seu	스
seug	슥
seugg	슦
seugs	슧
seun	슨
seunj	슩
seunh	슪
seud	슫
seul	슬
seulg	슭
seulm	슮
seulb	슯
seuls	슰
seult	슱
seulp	슲
seulh	슳
seum	슴
seub	습
seubs	슶
seus	슷
seuss	슸
seung	승
seuj	슺
seuc	슻
seuk	슼
seut	슽
seup	슾
seuh	슿
syi	싀
syig	싁
syigg	싂
syigs	싃
syin	싄
syinj	싅
syinh	싆
syid	싇
syil	싈
syilg	싉
syilm	싊
syilb	싋
syils	싌
syilt	싍
syilp	싎
syilh	싏
syim	싐
syib	싑
syibs	싒
syis	싓
syiss	싔
sying	싕
syij	싖
syic	싗
syik	싘
syit	싙
syip	싚
syih	싛
si	시
sig	식
sigg	싞
sigs	싟
sin	신
sinj	싡
sinh	싢
sid	싣
sil	실
silg	싥
silm	싦
silb	싧
sils	싨
silt	싩
silp	싪
silh	싫
sim	심
sib	십
sibs	싮
sis	싯
siss	싰
sing	싱
sij	싲
sic	싳
sik	싴
sit	싵
sip	싶
sih	싷
ssa	싸
ssag	싹
ssagg	싺
ssags	싻
ssan	싼
ssanj	싽
ssanh	싾
ssad	싿
ssal	쌀
ssalg	쌁
ssalm	쌂
ssalb	쌃
ssals	쌄
ssalt	쌅
ssalp	쌆
ssalh	쌇
ssam	쌈
ssab	쌉
ssabs	쌊
ssas	쌋
ssass	쌌
ssang	쌍
ssaj	쌎
ssac	쌏
ssak	쌐
ssat	쌑
ssap	쌒
ssah	쌓
ssae	쌔
ssaeg	쌕
ssaegg	쌖
ssaegs	쌗
ssaen	쌘
ssaenj	쌙
ssaenh	쌚
ssaed	쌛
ssael	쌜
ssaelg	쌝
ssaelm	쌞
ssaelb	쌟
ssaels	쌠
ssaelt	쌡
ssaelp	쌢
ssaelh	쌣
ssaem	쌤
ssaeb	쌥
ssaebs	쌦
ssaes	쌧
ssaess	쌨
ssaeng	쌩
ssaej	쌪
ssaec	쌫
ssaek	쌬
ssaet	쌭
ssaep	쌮
ssaeh	쌯
ssya	쌰
ssyag	쌱
ssyagg	쌲
ssyags	쌳
ssyan	쌴
ssyanj	쌵
ssyanh	쌶
ssyad	쌷
ssyal	쌸
ssyalg	쌹
ssyalm	쌺
ssyalb	쌻
ssyals	쌼
ssyalt	쌽
ssyalp	쌾
ssyalh	쌿
ssyam	썀
ssyab	썁
ssyabs	썂
ssyas	썃
ssyass	썄
ssyang	썅
ssyaj	썆
ssyac	썇
ssyak	썈
ssyat	썉
ssyap	썊
ssyah	썋
ssyae	썌
ssyaeg	썍
ssyaegg	썎
ssyaegs	썏
ssyaen	썐
ssyaenj	썑
ssyaenh	썒
ssyaed	썓
ssyael	썔
ssyaelg	썕
ssyaelm	썖
ssyaelb	썗
ssyaels	썘
ssyaelt	썙
ssyaelp	썚
ssyaelh	썛
ssyaem	썜
ssyaeb	썝
ssyaebs	썞
ssyaes	썟
ssyaess	썠
ssyaeng	썡
ssyaej	썢
ssyaec	썣
ssyaek	썤
ssyaet	썥
ssyaep	썦
ssyaeh	썧
sseo	써
sseog	썩
sseogg	썪
sseogs	썫
sseon	썬
sseonj	썭
sseonh	썮
sseod	썯
sseol	썰
sseolg	썱
sseolm	썲
sseolb	썳
sseols	썴
sseolt	썵
sseolp	썶
sseolh	썷
sseom	썸
sseob	썹
sseobs	썺
sseos	썻
sseoss	썼
sseong	썽
sseoj	썾
sseoc	썿
sseok	쎀
sseot	쎁
sseop	쎂
sseoh	쎃
sse	쎄
sseg	쎅
ssegg	쎆
ssegs	쎇
ssen	쎈
ssenj	쎉
ssenh	쎊
ssed	쎋
ssel	쎌
sselg	쎍
sselm	쎎
sselb	쎏
ssels	쎐
sselt	쎑
sselp	쎒
sselh	쎓
ssem	쎔
sseb	쎕
ssebs	쎖
sses	쎗
ssess	쎘
sseng	쎙
ssej	쎚
ssec	쎛
ssek	쎜
sset	쎝
ssep	쎞
sseh	쎟
ssyeo	쎠
ssyeog	쎡
ssyeogg	쎢
ssyeogs	쎣
ssyeon	쎤
ssyeonj	쎥
ssyeonh	쎦
ssyeod	쎧
ssyeol	쎨
ssyeolg	쎩
ssyeolm	쎪
ssyeolb	쎫
ssyeols	쎬
ssyeolt	쎭
ssyeolp	쎮
ssyeolh	쎯
ssyeom	쎰
ssyeob	쎱
ssyeobs	쎲
ssyeos	쎳
ssyeoss	쎴
ssyeong	쎵
ssyeoj	쎶
ssyeoc	쎷
ssyeok	쎸
ssyeot	쎹
ssyeop	쎺
ssyeoh	쎻
ssye	쎼
ssyeg	쎽
ssyegg	쎾
ssyegs	쎿
ssyen	쏀
ssyenj	쏁
ssyenh	쏂
ssyed	쏃
ssyel	쏄
ssyelg	쏅
ssyelm	쏆
ssyelb	쏇
ssyels	쏈
ssyelt	쏉
ssyelp	쏊
ssyelh	쏋
ssyem	쏌
ssyeb	쏍
ssyebs	쏎
ssyes	쏏
ssyess	쏐
ssyeng	쏑
ssyej	쏒
ssyec	쏓
ssyek	쏔
ssyet	쏕
ssyep	쏖
ssyeh	쏗
sso	쏘
ssog	쏙
ssogg	쏚
ssogs	쏛
sson	쏜
ssonj	쏝
ssonh	쏞
ssod	쏟
ssol	쏠
ssolg	쏡
ssolm	쏢
ssolb	쏣
ssols	쏤
ssolt	쏥
ssolp	쏦
ssolh	쏧
ssom	쏨
ssob	쏩
ssobs	쏪
ssos	쏫
ssoss	쏬
ssong	쏭
ssoj	쏮
ssoc	쏯
ssok	쏰
ssot	쏱
ssop	쏲
ssoh	쏳
sswa	쏴
sswag	쏵
sswagg	쏶
sswags	쏷
sswan	쏸
sswanj	쏹
sswanh	쏺
sswad	쏻
sswal	쏼
sswalg	쏽
sswalm	쏾
sswalb	쏿
sswals	쐀
sswalt	쐁
sswalp	쐂
sswalh	쐃
sswam	쐄
sswab	쐅
sswabs	쐆
sswas	쐇
sswass	쐈
sswang	쐉
sswaj	쐊
sswac	쐋
sswak	쐌
sswat	쐍
sswap	쐎
sswah	쐏
sswae	쐐
sswaeg	쐑
sswaegg	쐒
sswaegs	쐓
sswaen	쐔
sswaenj	쐕
sswaenh	쐖
sswaed	쐗
sswael	쐘
sswaelg	쐙
sswaelm	쐚
sswaelb	쐛
sswaels	쐜
sswaelt	쐝
sswaelp	쐞
sswaelh	쐟
sswaem	쐠
sswaeb	쐡
sswaebs	쐢
sswaes	쐣
sswaess	쐤
sswaeng	쐥
sswaej	쐦
sswaec	쐧
sswaek	쐨
sswaet	쐩
sswaep	쐪
sswaeh	쐫
ssoe	쐬
ssoeg	쐭
ssoegg	쐮
ssoegs	쐯
ssoen	쐰
ssoenj	쐱
ssoenh	쐲
ssoed	쐳
ssoel	쐴
ssoelg	쐵
ssoelm	쐶
ssoelb	쐷
ssoels	쐸
ssoelt	쐹
ssoelp	쐺
ssoelh	쐻
ssoem	쐼
ssoeb	쐽
ssoebs	쐾
ssoes	쐿
ssoess	쑀
ssoeng	쑁
ssoej	쑂
ssoec	쑃
ssoek	쑄
ssoet	쑅
ssoep	쑆
ssoeh	쑇
ssyo	쑈
ssyog	쑉
ssyogg	쑊
ssyogs	쑋
ssyon	쑌
ssyonj	쑍
ssyonh	쑎
ssyod	쑏
ssyol	쑐
ssyolg	쑑
ssyolm	쑒
ssyolb	쑓
ssyols	쑔
ssyolt	쑕
ssyolp	쑖
ssyolh	쑗
ssyom	쑘
ssyob	쑙
ssyobs	쑚
ssyos	쑛
ssyoss	쑜
ssyong	쑝
ssyoj	쑞
ssyoc	쑟
ssyok	쑠
ssyot	쑡
ssyop	쑢
ssyoh	쑣
ssu	쑤
ssug	쑥
ssugg	쑦
ssugs	쑧
ssun	쑨
ssunj	쑩
ssunh	쑪
ssud	쑫
ssul	쑬
ssulg	쑭
ssulm	쑮
ssulb	쑯
ssuls	쑰
ssult	쑱
ssulp	쑲
ssulh	쑳
ssum	쑴
ssub	쑵
ssubs	쑶
ssus	쑷
ssuss	쑸
ssung	쑹
ssuj	쑺
ssuc	쑻
ssuk	쑼
ssut	쑽
ssup	쑾
ssuh	쑿
ssweo	쒀
ssweog	쒁
ssweogg	쒂
ssweogs	쒃
ssweon	쒄
ssweonj	쒅
ssweonh	쒆
ssweod	쒇
ssweol	쒈
ssweolg	쒉
ssweolm	쒊
ssweolb	쒋
ssweols	쒌
ssweolt	쒍
ssweolp	쒎
ssweolh	쒏
ssweom	쒐
ssweob	쒑
ssweobs	쒒
ssweos	쒓
ssweoss	쒔
ssweong	쒕
ssweoj	쒖
ssweoc	쒗
ssweok	쒘
ssweot	쒙
ssweop	쒚
ssweoh	쒛
sswe	쒜
ssweg	쒝
sswegg	쒞
sswegs	쒟
sswen	쒠
sswenj	쒡
sswenh	쒢
sswed	쒣
sswel	쒤
sswelg	쒥
sswelm	쒦
sswelb	쒧
sswels	쒨
sswelt	쒩
sswelp	쒪
sswelh	쒫
sswem	쒬
ssweb	쒭
sswebs	쒮
sswes	쒯
sswess	쒰
ssweng	쒱
sswej	쒲
sswec	쒳
sswek	쒴
sswet	쒵
sswep	쒶
ssweh	쒷
sswi	쒸
sswig	쒹
sswigg	쒺
sswigs	쒻
sswin	쒼
sswinj	쒽
sswinh	쒾
sswid	쒿
sswil	쓀
sswilg	쓁
sswilm	쓂
sswilb	쓃
sswils	쓄
sswilt	쓅
sswilp	쓆
sswilh	쓇
sswim	쓈
sswib	쓉
sswibs	쓊
sswis	쓋
sswiss	쓌
sswing	쓍
sswij	쓎
sswic	쓏
sswik	쓐
sswit	쓑
sswip	쓒
sswih	쓓
ssyu	쓔
ssyug	쓕
ssyugg	쓖
ssyugs	쓗
ssyun	쓘
ssyunj	쓙
ssyunh	쓚
ssyud	쓛
ssyul	쓜
ssyulg	쓝
ssyulm	쓞
ssyulb	쓟
ssyuls	쓠
ssyult	쓡
ssyulp	쓢
ssyulh	쓣
ssyum	쓤
ssyub	쓥
ssyubs	쓦
ssyus	쓧
ssyuss	쓨
ssyung	쓩
ssyuj	쓪
ssyuc	쓫
ssyuk	쓬
ssyut	쓭
ssyup	쓮
ssyuh	쓯
sseu	쓰
sseug	쓱
sseugg	쓲
sseugs	쓳
sseun	쓴
sseunj	쓵
sseunh	쓶
sseud	쓷
sseul	쓸
sseulg	쓹
sseulm	쓺
sseulb	쓻
sseuls	쓼
sseult	쓽
sseulp	쓾
sseulh	쓿
sseum	씀
sseub	씁
sseubs	씂
sseus	씃
sseuss	씄
sseung	씅
sseuj	씆
sseuc	씇
sseuk	씈
sseut	씉
sseup	씊
sseuh	씋
ssyi	씌
ssyig	씍
ssyigg	씎
ssyigs	씏
ssyin	씐
ssyinj	씑
ssyinh	씒
ssyid	씓
ssyil	씔
ssyilg	씕
ssyilm	씖
ssyilb	씗
ssyils	씘
ssyilt	씙
ssyilp	씚
ssyilh	씛
ssyim	씜
ssyib	씝
ssyibs	씞
ssyis	씟
ssyiss	씠
ssying	씡
ssyij	씢
ssyic	씣
ssyik	씤
ssyit	씥
ssyip	씦
ssyih	씧
ssi	씨
ssig	씩
ssigg	씪
ssigs	씫
ssin	씬
ssinj	씭
ssinh	씮
ssid	씯
ssil	씰
ssilg	씱
ssilm	씲
ssilb	씳
ssils	씴
ssilt	씵
ssilp	씶
ssilh	씷
ssim	씸
ssib	씹
ssibs	씺
ssis	씻
ssiss	씼
ssing	씽
ssij	씾
ssic	씿
ssik	앀
ssit	앁
ssip	앂
ssih	앃
a	아
ag	악
agg	앆
ags	앇
an	안
anj	앉
anh	않
ad	앋
al	알
alg	앍
alm	앎
alb	앏
als	앐
alt	앑
alp	앒
alh	앓
am	암
ab	압
abs	앖
as	앗
ass	았
ang	앙
aj	앚
ac	앛
ak	앜
at	앝
ap	앞
ah	앟
ae	애
aeg	액
aegg	앢
aegs	앣
aen	앤
aenj	앥
aenh	앦
aed	앧
ael	앨
aelg	앩
aelm	앪
aelb	앫
aels	앬
aelt	앭
aelp	앮
aelh	앯
aem	앰
aeb	앱
aebs	앲
aes	앳
aess	앴
aeng	앵
aej	앶
aec	앷
aek	앸
aet	앹
aep	앺
aeh	앻
ya	야
yag	약
yagg	앾
yags	앿
yan	얀
yanj	얁
yanh	얂
yad	얃
yal	얄
yalg	얅
yalm	얆
yalb	얇
yals	얈
yalt	얉
yalp	얊
yalh	얋
yam	얌
yab	얍
yabs	얎
yas	얏
yass	얐
yang	양
yaj	얒
yac	얓
yak	얔
yat	얕
yap	얖
yah	얗
yae	얘
yaeg	얙
yaegg	얚
yaegs	얛
yaen	얜
yaenj	얝
yaenh	얞
yaed	얟
yael	얠
yaelg	얡
yaelm	얢
yaelb	얣
yaels	얤
yaelt	얥
yaelp	얦
yaelh	얧
yaem	얨
yaeb	얩
yaebs	얪
yaes	얫
yaess	얬
yaeng	얭
yaej	얮
yaec	얯
yaek	얰
yaet	얱
yaep	얲
yaeh	얳
eo	어
eog	억
eogg	얶
eogs	얷
eon	언
eonj	얹
eonh	얺
eod	얻
eol	얼
eolg	얽
eolm	얾
eolb	얿
eols	엀
eolt	엁
eolp	엂
eolh	엃
eom	엄
eob	업
eobs	없
eos	엇
eoss	었
eong	엉
eoj	엊
eoc	엋
eok	엌
eot	엍
eop	엎
eoh	엏
e	에
eg	엑
egg	엒
egs	엓
en	엔
enj	엕
enh	엖
ed	엗
el	엘
elg	엙
elm	엚
elb	엛
els	엜
elt	엝
elp	엞
elh	엟
em	엠
eb	엡
ebs	엢
es	엣
ess	엤
eng	엥
ej	엦
ec	엧
ek	엨
et	엩
ep	엪
eh	엫
yeo	여
yeog	역
yeogg	엮
yeogs	엯
yeon	연
yeonj	엱
yeonh	엲
yeod	엳
yeol	열
yeolg	엵
yeolm	엶
yeolb	엷
yeols	엸
yeolt	엹
yeolp	엺
yeolh	엻
yeom	염
yeob	엽
yeobs	엾
yeos	엿
yeoss	였
yeong	영
yeoj	옂
yeoc	옃
yeok	옄
yeot	옅
yeop	옆
yeoh	옇
ye	예
yeg	옉
yegg	옊
yegs	옋
yen	옌
yenj	옍
yenh	옎
yed	옏
yel	옐
yelg	옑
yelm	옒
yelb	옓
yels	옔
yelt	옕
yelp	옖
yelh	옗
yem	옘
yeb	옙
yebs	옚
yes	옛
yess	옜
yeng	옝
yej	옞
yec	옟
yek	옠
yet	옡
yep	옢
yeh	옣
o	오
og	옥
ogg	옦
ogs	옧
on	온
onj	옩
onh	옪
od	옫
ol	올
olg	옭
olm	옮
olb	옯
ols	옰
olt	옱
olp	옲
olh	옳
om	옴
ob	옵
obs	옶
os	옷
oss	옸
ong	옹
oj	옺
oc	옻
ok	옼
ot	옽
op	옾
oh	옿
wa	와
wag	왁
wagg	왂
wags	왃
wan	완
wanj	왅
wanh	왆
wad	왇
wal	왈
walg	왉
walm	왊
walb	왋
wals	왌
walt	왍
walp	왎
walh	왏
wam	왐
wab	왑
wabs	왒
was	왓
wass	왔
wang	왕
waj	왖
wac	왗
wak	왘
wat	왙
wap	왚
wah	왛
wae	왜
waeg	왝
waegg	왞
waegs	왟
waen	왠
waenj	왡
waenh	왢
waed	왣
wael	왤
waelg	왥
waelm	왦
waelb	왧
waels	왨
waelt	왩
waelp	왪
waelh	왫
waem	왬
waeb	왭
waebs	왮
waes	왯
waess	왰
waeng	왱
waej	왲
waec	왳
waek	왴
waet	왵
waep	왶
waeh	왷
oe	외
oeg	왹
oegg	왺
oegs	왻
oen	왼
oenj	왽
oenh	왾
oed	왿
oel	욀
oelg	욁
oelm	욂
oelb	욃
oels	욄
oelt	욅
oelp	욆
oelh	욇
oem	욈
oeb	욉
oebs	욊
oes	욋
oess	욌
oeng	욍
oej	욎
oec	욏
oek	욐
oet	욑
oep	욒
oeh	욓
yo	요
yog	욕
yogg	욖
yogs	욗
yon	욘
yonj	욙
yonh	욚
yod	욛
yol	욜
yolg	욝
yolm	욞
yolb	욟
yols	욠
yolt	욡
yolp	욢
yolh	욣
yom	욤
yob	욥
yobs	욦
yos	욧
yoss	욨
yong	용
yoj	욪
yoc	욫
yok	욬
yot	욭
yop	욮
yoh	욯
u	우
ug	욱
ugg	욲
ugs	욳
un	운
unj	욵
unh	욶
ud	욷
ul	울
ulg	욹
ulm	욺
ulb	욻
uls	욼
ult	욽
ulp	욾
ulh	욿
um	움
ub	웁
ubs	웂
us	웃
uss	웄
ung	웅
uj	웆
uc	웇
uk	웈
ut	웉
up	웊
uh	웋
weo	워
weog	웍
weogg	웎
weogs	웏
weon	원
weonj	웑
weonh	웒
weod	웓
weol	월
weolg	웕
weolm	웖
weolb	웗
weols	웘
weolt	웙
weolp	웚
weolh	웛
weom	웜
weob	웝
weobs	웞
weos	웟
weoss	웠
weong	웡
weoj	웢
weoc	웣
weok	웤
weot	웥
weop	웦
weoh	웧
we	웨
weg	웩
wegg	웪
wegs	웫
wen	웬
wenj	웭
wenh	웮
wed	웯
wel	웰
welg	웱
welm	웲
welb	웳
wels	웴
welt	웵
welp	웶
welh	웷
wem	웸
web	웹
webs	웺
wes	웻
wess	웼
weng	웽
wej	웾
wec	웿
wek	윀
wet	윁
wep	윂
weh	윃
wi	위
wig	윅
wigg	윆
wigs	윇
win	윈
winj	윉
winh	윊
wid	윋
wil	윌
wilg	윍
wilm	윎
wilb	윏
wils	윐
wilt	윑
wilp	윒
wilh	윓
wim	윔
wib	윕
wibs	윖
wis	윗
wiss	윘
wing	윙
wij	윚
wic	윛
wik	윜
wit	윝
wip	윞
wih	윟
yu	유
yug	육
yugg	윢
yugs	윣
yun	윤
yunj	윥
yunh	윦
yud	윧
yul	율
yulg	윩
yulm	윪
yulb	윫
yuls	윬
yult	윭
yulp	윮
yulh	윯
yum	윰
yub	윱
yubs	윲
yus	윳
yuss	윴
yung	융
yuj	윶
yuc	윷
yuk	윸
yut	윹
yup	윺
yuh	윻
eu	으
eug	윽
eugg	윾
eugs	윿
eun	은
eunj	읁
eunh	읂
eud	읃
eul	을
eulg	읅
eulm	읆
eulb	읇
euls	읈
eult	읉
eulp	읊
eulh	읋
eum	음
eub	읍
eubs	읎
eus	읏
euss	읐
eung	응
euj	읒
euc	읓
euk	읔
eut	읕
eup	읖
euh	읗
yi	의
yig	읙
yigg	읚
yigs	읛
yin	읜
yinj	읝
yinh	읞
yid	읟
yil	읠
yilg	읡
yilm	읢
yilb	읣
yils	읤
yilt	읥
yilp	읦
yilh	읧
yim	읨
yib	읩
yibs	읪
yis	읫
yiss	읬
ying	읭
yij	읮
yic	읯
yik	읰
yit	읱
yip	읲
yih	읳
i	이
ig	익
igg	읶
igs	읷
in	인
inj	읹
inh	읺
id	읻
il	일
ilg	읽
ilm	읾
ilb	읿
ils	잀
ilt	잁
ilp	잂
ilh	잃
im	임
ib	입
ibs	잆
is	잇
iss	있
ing	잉
ij	잊
ic	잋
ik	잌
it	잍
ip	잎
ih	잏
ja	자
jag	작
jagg	잒
jags	잓
jan	잔
janj	잕
janh	잖
jad	잗
jal	잘
jalg	잙
jalm	잚
jalb	잛
jals	잜
jalt	잝
jalp	잞
jalh	잟
jam	잠
jab	잡
jabs	잢
jas	잣
jass	잤
jang	장
jaj	잦
jac	잧
jak	잨
jat	잩
jap	잪
jah	잫
jae	재
jaeg	잭
jaegg	잮
jaegs	잯
jaen	잰
jaenj	잱
jaenh	잲
jaed	잳
jael	잴
jaelg	잵
jaelm	잶
jaelb	잷
jaels	잸
jaelt	잹
jaelp	잺
jaelh	잻
jaem	잼
jaeb	잽
jaebs	잾
jaes	잿
jaess	쟀
jaeng	쟁
jaej	쟂
jaec	쟃
jaek	쟄
jaet	쟅
jaep	쟆
jaeh	쟇
jya	쟈
jyag	쟉
jyagg	쟊
jyags	쟋
jyan	쟌
jyanj	쟍
jyanh	쟎
jyad	쟏
jyal	쟐
jyalg	쟑
jyalm	쟒
jyalb	쟓
jyals	쟔
jyalt	쟕
jyalp	쟖
jyalh	쟗
jyam	쟘
jyab	쟙
jyabs	쟚
jyas	쟛
jyass	쟜
jyang	쟝
jyaj	쟞
jyac	쟟
jyak	쟠
jyat	쟡
jyap	쟢
jyah	쟣
jyae	쟤
jyaeg	쟥
jyaegg	쟦
jyaegs	쟧
jyaen	쟨
jyaenj	쟩
jyaenh	쟪
jyaed	쟫
jyael	쟬
jyaelg	쟭
jyaelm	쟮
jyaelb	쟯
jyaels	쟰
jyaelt	쟱
jyaelp	쟲
jyaelh	쟳
jyaem	쟴
jyaeb	쟵
jyaebs	쟶
jyaes	쟷
jyaess	쟸
jyaeng	쟹
jyaej	쟺
jyaec	쟻
jyaek	쟼
jyaet	쟽
jyaep	쟾
jyaeh	쟿
jeo	저
jeog	적
jeogg	젂
jeogs	젃
jeon	전
jeonj	젅
jeonh	젆
jeod	젇
jeol	절
jeolg	젉
jeolm	젊
jeolb	젋
jeols	젌
jeolt	젍
jeolp	젎
jeolh	젏
jeom	점
jeob	접
jeobs	젒
jeos	젓
jeoss	젔
jeong	정
jeoj	젖
jeoc	젗
jeok	젘
jeot	젙
jeop	젚
jeoh	젛
je	제
jeg	젝
jegg	젞
jegs	젟
jen	젠
jenj	젡
jenh	젢
jed	젣
jel	젤
jelg	젥
jelm	젦
jelb	젧
jels	젨
jelt	젩
jelp	젪
jelh	젫
jem	젬
jeb	젭
jebs	젮
jes	젯
jess	젰
jeng	젱
jej	젲
jec	젳
jek	젴
jet	젵
jep	젶
jeh	젷
jyeo	져
jyeog	젹
jyeogg	젺
jyeogs	젻
jyeon	젼
jyeonj	젽
jyeonh	젾
jyeod	젿
jyeol	졀
jyeolg	졁
jyeolm	졂
jyeolb	졃
jyeols	졄
jyeolt	졅
jyeolp	졆
jyeolh	졇
jyeom	졈
jyeob	졉
jyeobs	졊
jyeos	졋
jyeoss	졌
jyeong	졍
jyeoj	졎
jyeoc	졏
jyeok	졐
jyeot	졑
jyeop	졒
jyeoh	졓
jye	졔
jyeg	졕
jyegg	졖
jyegs	졗
jyen	졘
jyenj	졙
jyenh	졚
jyed	졛
jyel	졜
jyelg	졝
jyelm	졞
jyelb	졟
jyels	졠
jyelt	졡
jyelp	졢
jyelh	졣
jyem	졤
jyeb	졥
jyebs	졦
jyes	졧
jyess	졨
jyeng	졩
jyej	졪
jyec	졫
jyek	졬
jyet	졭
jyep	졮
jyeh	졯
jo	조
jog	족
jogg	졲
jogs	졳
jon	존
jonj	졵
jonh	졶
jod	졷
jol	졸
jolg	졹
jolm	졺
jolb	졻
jols	졼
jolt	졽
jolp	졾
jolh	졿
jom	좀
job	좁
jobs	좂
jos	좃
joss	좄
jong	종
joj	좆
joc	좇
jok	좈
jot	좉
jop	좊
joh	좋
jwa	좌
jwag	좍
jwagg	좎
jwags	좏
jwan	좐
jwanj	좑
jwanh	좒
jwad	좓
jwal	좔
jwalg	좕
jwalm	좖
jwalb	좗
jwals	좘
jwalt	좙
jwalp	좚
jwalh	좛
jwam	좜
jwab	좝
jwabs	좞
jwas	좟
jwass	좠
jwang	좡
jwaj	좢
jwac	좣
jwak	좤
jwat	좥
jwap	좦
jwah	좧
jwae	좨
jwaeg	좩
jwaegg	좪
jwaegs	좫
jwaen	좬
jwaenj	좭
jwaenh	좮
jwaed	좯
jwael	좰
jwaelg	좱
jwaelm	좲
jwaelb	좳
jwaels	좴
jwaelt	좵
jwaelp	좶
jwaelh	좷
jwaem	좸
jwaeb	좹
jwaebs	좺
jwaes	좻
jwaess	좼
jwaeng	좽
jwaej	좾
jwaec	좿
jwaek	죀
jwaet	죁
jwaep	죂
jwaeh	죃
joe	죄
joeg	죅
joegg	죆
joegs	죇
joen	죈
joenj	죉
joenh	죊
joed	죋
joel	죌
joelg	죍
joelm	죎
joelb	죏
joels	죐
joelt	죑
joelp	죒
joelh	죓
joem	죔
joeb	죕
joebs	죖
joes	죗
joess	죘
joeng	죙
joej	죚
joec	죛
joek	죜
joet	죝
joep	죞
joeh	죟
jyo	죠
jyog	죡
jyogg	죢
jyogs	죣
jyon	죤
jyonj	죥
jyonh	죦
jyod	죧
jyol	죨
jyolg	죩
jyolm	죪
jyolb	죫
jyols	죬
jyolt	죭
jyolp	죮
jyolh	죯
jyom	죰
jyob	죱
jyobs	죲
jyos	죳
jyoss	죴
jyong	죵
jyoj	죶
jyoc	죷
jyok	죸
jyot	죹
jyop	죺
jyoh	죻
ju	주
jug	죽
jugg	죾
jugs	죿
jun	준
junj	줁
junh	줂
jud	줃
jul	줄
julg	줅
julm	줆
julb	줇
juls	줈
jult	줉
julp	줊
julh	줋
jum	줌
jub	줍
jubs	줎
jus	줏
juss	줐
jung	중
juj	줒
juc	줓
juk	줔
jut	줕
jup	줖
juh	줗
jweo	줘
jweog	줙
jweogg	줚
jweogs	줛
jweon	줜
jweonj	줝
jweonh	줞
jweod	줟
jweol	줠
jweolg	줡
jweolm	줢
jweolb	줣
jweols	줤
jweolt	줥
jweolp	줦
jweolh	줧
jweom	줨
jweob	줩
jweobs	줪
jweos	줫
jweoss	줬
jweong	줭
jweoj	줮
jweoc	줯
jweok	줰
jweot	줱
jweop	줲
jweoh	줳
jwe	줴
jweg	줵
jwegg	줶
jwegs	줷
jwen	줸
jwenj	줹
jwenh	줺
jwed	줻
jwel	줼
jwelg	줽
jwelm	줾
jwelb	줿
jwels	쥀
jwelt	쥁
jwelp	쥂
jwelh	쥃
jwem	쥄
jweb	쥅
jwebs	쥆
jwes	쥇
jwess	쥈
jweng	쥉
jwej	쥊
jwec	쥋
jwek	쥌
jwet	쥍
jwep	쥎
jweh	쥏
jwi	쥐
jwig	쥑
jwigg	쥒
jwigs	쥓
jwin	쥔
jwinj	쥕
jwinh	쥖
jwid	쥗
jwil	쥘
jwilg	쥙
jwilm	쥚
jwilb	쥛
jwils	쥜
jwilt	쥝
jwilp	쥞
jwilh	쥟
jwim	쥠
jwib	쥡
jwibs	쥢
jwis	쥣
jwiss	쥤
jwing	쥥
jwij	쥦
jwic	쥧
jwik	쥨
jwit	쥩
jwip	쥪
jwih	쥫
jyu	쥬
jyug	쥭
jyugg	쥮
jyugs	쥯
jyun	쥰
jyunj	쥱
jyunh	쥲
jyud	쥳
jyul	쥴
jyulg	쥵
jyulm	쥶
jyulb	쥷
jyuls	쥸
jyult	쥹
jyulp	쥺
jyulh	쥻
jyum	쥼
jyub	쥽
jyubs	쥾
jyus	쥿
jyuss	즀
jyung	즁
jyuj	즂
jyuc	즃
jyuk	즄
jyut	즅
jyup	즆
jyuh	즇
jeu	즈
jeug	즉
jeugg	즊
jeugs	즋
jeun	즌
jeunj	즍
jeunh	즎
jeud	즏
jeul	즐
jeulg	즑
jeulm	즒
jeulb	즓
jeuls	즔
jeult	즕
jeulp	즖
jeulh	즗
jeum	즘
jeub	즙
jeubs	즚
jeus	즛
jeuss	즜
jeung	증
jeuj	즞
jeuc	즟
jeuk	즠
jeut	즡
jeup	즢
jeuh	즣
jyi	즤
jyig	즥
jyigg	즦
jyigs	즧
jyin	즨
jyinj	즩
jyinh	즪
jyid	즫
jyil	즬
jyilg	즭
jyilm	즮
jyilb	즯
jyils	즰
jyilt	즱
jyilp	즲
jyilh	즳
jyim	즴
jyib	즵
jyibs	즶
jyis	즷
jyiss	즸
jying	즹
jyij	즺
jyic	즻
jyik	즼
jyit	즽
jyip	즾
jyih	즿
ji	지
jig	직
jigg	짂
jigs	짃
jin	진
jinj	짅
jinh	짆
jid	짇
jil	질
jilg	짉
jilm	짊
jilb	짋
jils	짌
jilt	짍
jilp	짎
jilh	짏
jim	짐
jib	집
jibs	짒
jis	짓
jiss	짔
jing	징
jij	짖
jic	짗
jik	짘
jit	짙
jip	짚
jih	짛
jja	짜
jjag	짝
jjagg	짞
jjags	짟
jjan	짠
jjanj	짡
jjanh	짢
jjad	짣
jjal	짤
jjalg	짥
jjalm	짦
jjalb	짧
jjals	짨
jjalt	짩
jjalp	짪
jjalh	짫
jjam	짬
jjab	짭
jjabs	짮
jjas	짯
jjass	짰
jjang	짱
jjaj	짲
jjac	짳
jjak	짴
jjat	짵
jjap	짶
jjah	짷
jjae	째
jjaeg	짹
jjaegg	짺
jjaegs	짻
jjaen	짼
jjaenj	짽
jjaenh	짾
jjaed	짿
jjael	쨀
jjaelg	쨁
jjaelm	쨂
jjaelb	쨃
jjaels	쨄
jjaelt	쨅
jjaelp	쨆
jjaelh	쨇
jjaem	쨈
jjaeb	쨉
jjaebs	쨊
jjaes	쨋
jjaess	쨌
jjaeng	쨍
jjaej	쨎
jjaec	쨏
jjaek	쨐
jjaet	쨑
jjaep	쨒
jjaeh	쨓
jjya	쨔
jjyag	쨕
jjyagg	쨖
jjyags	쨗
jjyan	쨘
jjyanj	쨙
jjyanh	쨚
jjyad	쨛
jjyal	쨜
jjyalg	쨝
jjyalm	쨞
jjyalb	쨟
jjyals	쨠
jjyalt	쨡
jjyalp	쨢
jjyalh	쨣
jjyam	쨤
jjyab	쨥
jjyabs	쨦
jjyas	쨧
jjyass	쨨
jjyang	쨩
jjyaj	쨪
jjyac	쨫
jjyak	쨬
jjyat	쨭
jjyap	쨮
jjyah	쨯
jjyae	쨰
jjyaeg	쨱
jjyaegg	쨲
jjyaegs	쨳
jjyaen	쨴
jjyaenj	쨵
jjyaenh	쨶
jjyaed	쨷
jjyael	쨸
jjyaelg	쨹
jjyaelm	쨺
jjyaelb	쨻
jjyaels	쨼
jjyaelt	쨽
jjyaelp	쨾
jjyaelh	쨿
jjyaem	쩀
jjyaeb	쩁
jjyaebs	쩂
jjyaes	쩃
jjyaess	쩄
jjyaeng	쩅
jjyaej	쩆
jjyaec	쩇
jjyaek	쩈
jjyaet	쩉
jjyaep	쩊
jjyaeh	쩋
jjeo	쩌
jjeog	쩍
jjeogg	쩎
jjeogs	쩏
jjeon	쩐
jjeonj	쩑
jjeonh	쩒
jjeod	쩓
jjeol	쩔
jjeolg	쩕
jjeolm	쩖
jjeolb	쩗
jjeols	쩘
jjeolt	쩙
jjeolp	쩚
jjeolh	쩛
jjeom	쩜
jjeob	쩝
jjeobs	쩞
jjeos	쩟
jjeoss	쩠
jjeong	쩡
jjeoj	쩢
jjeoc	쩣
jjeok	쩤
jjeot	쩥
jjeop	쩦
jjeoh	쩧
jje	쩨
jjeg	쩩
jjegg	쩪
jjegs	쩫
jjen	쩬
jjenj	쩭
jjenh	쩮
jjed	쩯
jjel	쩰
jjelg	쩱
jjelm	쩲
jjelb	쩳
jjels	쩴
jjelt	쩵
jjelp	쩶
jjelh	쩷
jjem	쩸
jjeb	쩹
jjebs	쩺
jjes	쩻
jjess	쩼
jjeng	쩽
jjej	쩾
jjec	쩿
jjek	쪀
jjet	쪁
jjep	쪂
jjeh	쪃
jjyeo	쪄
jjyeog	쪅
jjyeogg	쪆
jjyeogs	쪇
jjyeon	쪈
jjyeonj	쪉
jjyeonh	쪊
jjyeod	쪋
jjyeol	쪌
jjyeolg	쪍
jjyeolm	쪎
jjyeolb	쪏
jjyeols	쪐
jjyeolt	쪑
jjyeolp	쪒
jjyeolh	쪓
jjyeom	쪔
jjyeob	쪕
jjyeobs	쪖
jjyeos	쪗
jjyeoss	쪘
jjyeong	쪙
jjyeoj	쪚
jjyeoc	쪛
jjyeok	쪜
jjyeot	쪝
jjyeop	쪞
jjyeoh	쪟
jjye	쪠
jjyeg	쪡
jjyegg	쪢
jjyegs	쪣
jjyen	쪤
jjyenj	쪥
jjyenh	쪦
jjyed	쪧
jjyel	쪨
jjyelg	쪩
jjyelm	쪪
jjyelb	쪫
jjyels	쪬
jjyelt	쪭
jjyelp	쪮
jjyelh	쪯
jjyem	쪰
jjyeb	쪱
jjyebs	쪲
jjyes	쪳
jjyess	쪴
jjyeng	쪵
jjyej	쪶
jjyec	쪷
jjyek	쪸
jjyet	쪹
jjyep	쪺
jjyeh	쪻
jjo	쪼
jjog	쪽
jjogg	쪾
jjogs	쪿
jjon	쫀
jjonj	쫁
jjonh	쫂
jjod	쫃
jjol	쫄
jjolg	쫅
jjolm	쫆
jjolb	쫇
jjols	쫈
jjolt	쫉
jjolp	쫊
jjolh	쫋
jjom	쫌
jjob	쫍
jjobs	쫎
jjos	쫏
jjoss	쫐
jjong	쫑
jjoj	쫒
jjoc	쫓
jjok	쫔
jjot	쫕
jjop	쫖
jjoh	쫗
jjwa	쫘
jjwag	쫙
jjwagg	쫚
jjwags	쫛
jjwan	쫜
jjwanj	쫝
jjwanh	쫞
jjwad	쫟
jjwal	쫠
jjwalg	쫡
jjwalm	쫢
jjwalb	쫣
jjwals	쫤
jjwalt	쫥
jjwalp	쫦
jjwalh	쫧
jjwam	쫨
jjwab	쫩
jjwabs	쫪
jjwas	쫫
jjwass	쫬
jjwang	쫭
jjwaj	쫮
jjwac	쫯
jjwak	쫰
jjwat	쫱
jjwap	쫲
jjwah	쫳
jjwae	쫴
jjwaeg	쫵
jjwaegg	쫶
jjwaegs	쫷
jjwaen	쫸
jjwaenj	쫹
jjwaenh	쫺
jjwaed	쫻
jjwael	쫼
jjwaelg	쫽
jjwaelm	쫾
jjwaelb	쫿
jjwaels	쬀
jjwaelt	쬁
jjwaelp	쬂
jjwaelh	쬃
jjwaem	쬄
jjwaeb	쬅
jjwaebs	쬆
jjwaes	쬇
jjwaess	쬈
jjwaeng	쬉
jjwaej	쬊
jjwaec	쬋
jjwaek	쬌
jjwaet	쬍
jjwaep	쬎
jjwaeh	쬏
jjoe	쬐
jjoeg	쬑
jjoegg	쬒
jjoegs	쬓
jjoen	쬔
jjoenj	쬕
jjoenh	쬖
jjoed	쬗
jjoel	쬘
jjoelg	쬙
jjoelm	쬚
jjoelb	쬛
jjoels	쬜
jjoelt	쬝
jjoelp	쬞
jjoelh	쬟
jjoem	쬠
jjoeb	쬡
jjoebs	쬢
jjoes	쬣
jjoess	쬤
jjoeng	쬥
jjoej	쬦
jjoec	쬧
jjoek	쬨
jjoet	쬩
jjoep	쬪
jjoeh	쬫
jjyo	쬬
jjyog	쬭
jjyogg	쬮
jjyogs	쬯
jjyon	쬰
jjyonj	쬱
jjyonh	쬲
jjyod	쬳
jjyol	쬴
jjyolg	쬵
jjyolm	쬶
jjyolb	쬷
jjyols	쬸
jjyolt	쬹
jjyolp	쬺
jjyolh	쬻
jjyom	쬼
jjyob	쬽
jjyobs	쬾
jjyos	쬿
jjyoss	쭀
jjyong	쭁
jjyoj	쭂
jjyoc	쭃
jjyok	쭄
jjyot	쭅
jjyop	쭆
jjyoh	쭇
jju	쭈
jjug	쭉
jjugg	쭊
jjugs	쭋
jjun	쭌
jjunj	쭍
jjunh	쭎
jjud	쭏
jjul	쭐
jjulg	쭑
jjulm	쭒
jjulb	쭓
jjuls	쭔
jjult	쭕
jjulp	쭖
jjulh	쭗
jjum	쭘
jjub	쭙
jjubs	쭚
jjus	쭛
jjuss	쭜
jjung	쭝
jjuj	쭞
jjuc	쭟
jjuk	쭠
jjut	쭡
jjup	쭢
jjuh	쭣
jjweo	쭤
jjweog	쭥
jjweogg	쭦
jjweogs	쭧
jjweon	쭨
jjweonj	쭩
jjweonh	쭪
jjweod	쭫
jjweol	쭬
jjweolg	쭭
jjweolm	쭮
jjweolb	쭯
jjweols	쭰
jjweolt	쭱
jjweolp	쭲
jjweolh	쭳
jjweom	쭴
jjweob	쭵
jjweobs	쭶
jjweos	쭷
jjweoss	쭸
jjweong	쭹
jjweoj	쭺
jjweoc	쭻
jjweok	쭼
jjweot	쭽
jjweop	쭾
jjweoh	쭿
jjwe	쮀
jjweg	쮁
jjwegg	쮂
jjwegs	쮃
jjwen	쮄
jjwenj	쮅
jjwenh	쮆
jjwed	쮇
jjwel	쮈
jjwelg	쮉
jjwelm	쮊
jjwelb	쮋
jjwels	쮌
jjwelt	쮍
jjwelp	쮎
jjwelh	쮏
jjwem	쮐
jjweb	쮑
jjwebs	쮒
jjwes	쮓
jjwess	쮔
jjweng	쮕
jjwej	쮖
jjwec	쮗
jjwek	쮘
jjwet	쮙
jjwep	쮚
jjweh	쮛
jjwi	쮜
jjwig	쮝
jjwigg	쮞
jjwigs	쮟
jjwin	쮠
jjwinj	쮡
jjwinh	쮢
jjwid	쮣
jjwil	쮤
jjwilg	쮥
jjwilm	쮦
jjwilb	쮧
jjwils	쮨
jjwilt	쮩
jjwilp	쮪
jjwilh	쮫
jjwim	쮬
jjwib	쮭
jjwibs	쮮
jjwis	쮯
jjwiss	쮰
jjwing	쮱
jjwij	쮲
jjwic	쮳
jjwik	쮴
jjwit	쮵
jjwip	쮶
jjwih	쮷
jjyu	쮸
jjyug	쮹
jjyugg	쮺
jjyugs	쮻
jjyun	쮼
jjyunj	쮽
jjyunh	쮾
jjyud	쮿
jjyul	쯀
jjyulg	쯁
jjyulm	쯂
jjyulb	쯃
jjyuls	쯄
jjyult	쯅
jjyulp	쯆
jjyulh	쯇
jjyum	쯈
jjyub	쯉
jjyubs	쯊
jjyus	쯋
jjyuss	쯌
jjyung	쯍
jjyuj	쯎
jjyuc	쯏
jjyuk	쯐
jjyut	쯑
jjyup	쯒
jjyuh	쯓
jjeu	쯔
jjeug	쯕
jjeugg	쯖
jjeugs	쯗
jjeun	쯘
jjeunj	쯙
jjeunh	쯚
jjeud	쯛
jjeul	쯜
jjeulg	쯝
jjeulm	쯞
jjeulb	쯟
jjeuls	쯠
jjeult	쯡
jjeulp	쯢
jjeulh	쯣
jjeum	쯤
jjeub	쯥
jjeubs	쯦
jjeus	쯧
jjeuss	쯨
jjeung	쯩
jjeuj	쯪
jjeuc	쯫
jjeuk	쯬
jjeut	쯭
jjeup	쯮
jjeuh	쯯
jjyi	쯰
jjyig	쯱
jjyigg	쯲
jjyigs	쯳
jjyin	쯴
jjyinj	쯵
jjyinh	쯶
jjyid	쯷
jjyil	쯸
jjyilg	쯹
jjyilm	쯺
jjyilb	쯻
jjyils	쯼
jjyilt	쯽
jjyilp	쯾
jjyilh	쯿
jjyim	찀
jjyib	찁
jjyibs	찂
jjyis	찃
jjyiss	찄
jjying	찅
jjyij	찆
jjyic	찇
jjyik	찈
jjyit	찉
jjyip	찊
jjyih	찋
jji	찌
jjig	찍
jjigg	찎
jjigs	찏
jjin	찐
jjinj	찑
jjinh	찒
jjid	찓
jjil	찔
jjilg	찕
jjilm	찖
jjilb	찗
jjils	찘
jjilt	찙
jjilp	찚
jjilh	찛
jjim	찜
jjib	찝
jjibs	찞
jjis	찟
jjiss	찠
jjing	찡
jjij	찢
jjic	찣
jjik	찤
jjit	찥
jjip	찦
jjih	찧
ca	차
cag	착
cagg	찪
cags	찫
can	찬
canj	찭
canh	찮
cad	찯
cal	찰
calg	찱
calm	찲
calb	찳
cals	찴
calt	찵
calp	찶
calh	찷
cam	참
cab	찹
cabs	찺
cas	찻
cass	찼
cang	창
caj	찾
cac	찿
cak	챀
cat	챁
cap	챂
cah	챃
cae	채
caeg	책
caegg	챆
caegs	챇
caen	챈
caenj	챉
caenh	챊
caed	챋
cael	챌
caelg	챍
caelm	챎
caelb	챏
caels	챐
caelt	챑
caelp	챒
caelh	챓
caem	챔
caeb	챕
caebs	챖
caes	챗
caess	챘
caeng	챙
caej	챚
caec	챛
caek	챜
caet	챝
caep	챞
caeh	챟
cya	챠
cyag	챡
cyagg	챢
cyags	챣
cyan	챤
cyanj	챥
cyanh	챦
cyad	챧
cyal	챨
cyalg	챩
cyalm	챪
cyalb	챫
cyals	챬
cyalt	챭
cyalp	챮
cyalh	챯
cyam	챰
cyab	챱
cyabs	챲
cyas	챳
cyass	챴
cyang	챵
cyaj	챶
cyac	챷
cyak	챸
cyat	챹
cyap	챺
cyah	챻
cyae	챼
cyaeg	챽
cyaegg	챾
cyaegs	챿
cyaen	첀
cyaenj	첁
cyaenh	첂
cyaed	첃
cyael	첄
cyaelg	첅
cyaelm	첆
cyaelb	첇
cyaels	첈
cyaelt	첉
cyaelp	첊
cyaelh	첋
cyaem	첌
cyaeb	첍
cyaebs	첎
cyaes	첏
cyaess	첐
cyaeng	첑
cyaej	첒
cyaec	첓
cyaek	첔
cyaet	첕
cyaep	첖
cyaeh	첗
ceo	처
ceog	척
ceogg	첚
ceogs	첛
ceon	천
ceonj	첝
ceonh	첞
ceod	첟
ceol	철
ceolg	첡
ceolm	첢
ceolb	첣
ceols	첤
ceolt	첥
ceolp	첦
ceolh	첧
ceom	첨
ceob	첩
ceobs	첪
ceos	첫
ceoss	첬
ceong	청
ceoj	첮
ceoc	첯
ceok	첰
ceot	첱
ceop	첲
ceoh	첳
ce	체
ceg	첵
cegg	첶
cegs	첷
cen	첸
cenj	첹
cenh	첺
ced	첻
cel	첼
celg	첽
celm	첾
celb	첿
cels	쳀
celt	쳁
celp	쳂
celh	쳃
cem	쳄
ceb	쳅
cebs	쳆
ces	쳇
cess	쳈
ceng	쳉
cej	쳊
cec	쳋
cek	쳌
cet	쳍
cep	쳎
ceh	쳏
cyeo	쳐
cyeog	쳑
cyeogg	쳒
cyeogs	쳓
cyeon	쳔
cyeonj	쳕
cyeonh	쳖
cyeod	쳗
cyeol	쳘
cyeolg	쳙
cyeolm	쳚
cyeolb	쳛
cyeols	쳜
cyeolt	쳝
cyeolp	쳞
cyeolh	쳟
cyeom	쳠
cyeob	쳡
cyeobs	쳢
cyeos	쳣
cyeoss	쳤
cyeong	쳥
cyeoj	쳦
cyeoc	쳧
cyeok	쳨
cyeot	쳩
cyeop	쳪
cyeoh	쳫
cye	쳬
cyeg	쳭
cyegg	쳮
cyegs	쳯
cyen	쳰
cyenj	쳱
cyenh	쳲
cyed	쳳
cyel	쳴
cyelg	쳵
cyelm	쳶
cyelb	쳷
cyels	쳸
cyelt	쳹
cyelp	쳺
cyelh	쳻
cyem	쳼
cyeb	쳽
cyebs	쳾
cyes	쳿
cyess	촀
cyeng	촁
cyej	촂
cyec	촃
cyek	촄
cyet	촅
cyep	촆
cyeh	촇
co	초
cog	촉
cogg	촊
cogs	촋
con	촌
conj	촍
conh	촎
cod	촏
col	촐
colg	촑
colm	촒
colb	촓
cols	촔
colt	촕
colp	촖
colh	촗
com	촘
cob	촙
cobs	촚
cos	촛
coss	촜
cong	총
coj	촞
coc	촟
cok	촠
cot	촡
cop	촢
coh	촣
cwa	촤
cwag	촥
cwagg	촦
cwags	촧
cwan	촨
cwanj	촩
cwanh	촪
cwad	촫
cwal	촬
cwalg	촭
cwalm	촮
cwalb	촯
cwals	촰
cwalt	촱
cwalp	촲
cwalh	촳
cwam	촴
cwab	촵
cwabs	촶
cwas	촷
cwass	촸
cwang	촹
cwaj	촺
cwac	촻
cwak	촼
cwat	촽
cwap	촾
cwah	촿
cwae	쵀
cwaeg	쵁
cwaegg	쵂
cwaegs	쵃
cwaen	쵄
cwaenj	쵅
cwaenh	쵆
cwaed	쵇
cwael	쵈
cwaelg	쵉
cwaelm	쵊
cwaelb	쵋
cwaels	쵌
cwaelt	쵍
cwaelp	쵎
cwaelh	쵏
cwaem	쵐
cwaeb	쵑
cwaebs	쵒
cwaes	쵓
cwaess	쵔
cwaeng	쵕
cwaej	쵖
cwaec	쵗
cwaek	쵘
cwaet	쵙
cwaep	쵚
cwaeh	쵛
coe	최
coeg	쵝
coegg	쵞
coegs	쵟
coen	쵠
coenj	쵡
coenh	쵢
coed	쵣
coel	쵤
coelg	쵥
coelm	쵦
coelb	쵧
coels	쵨
coelt	쵩
coelp	쵪
coelh	쵫
coem	쵬
coeb	쵭
coebs	쵮
coes	쵯
coess	쵰
coeng	쵱
coej	쵲
coec	쵳
coek	쵴
coet	쵵
coep	쵶
coeh	쵷
cyo	쵸
cyog	쵹
cyogg	쵺
cyogs	쵻
cyon	쵼
cyonj	쵽
cyonh	쵾
cyod	쵿
cyol	춀
cyolg	춁
cyolm	춂
cyolb	춃
cyols	춄
cyolt	춅
cyolp	춆
cyolh	춇
cyom	춈
cyob	춉
cyobs	춊
cyos	춋
cyoss	춌
cyong	춍
cyoj	춎
cyoc	춏
cyok	춐
cyot	춑
cyop	춒
cyoh	춓
cu	추
cug	축
cugg	춖
cugs	춗
cun	춘
cunj	춙
cunh	춚
cud	춛
cul	출
culg	춝
culm	춞
culb	춟
culs	춠
cult	춡
culp	춢
culh	춣
cum	춤
cub	춥
cubs	춦
cus	춧
cuss	춨
cung	충
cuj	춪
cuc	춫
cuk	춬
cut	춭
cup	춮
cuh	춯
cweo	춰
cweog	춱
cweogg	춲
cweogs	춳
cweon	춴
cweonj	춵
cweonh	춶
cweod	춷
cweol	춸
cweolg	춹
cweolm	춺
cweolb	춻
cweols	춼
cweolt	춽
cweolp	춾
cweolh	춿
cweom	췀
cweob	췁
cweobs	췂
cweos	췃
cweoss	췄
cweong	췅
cweoj	췆
cweoc	췇
cweok	췈
cweot	췉
cweop	췊
cweoh	췋
cwe	췌
cweg	췍
cwegg	췎
cwegs	췏
cwen	췐
cwenj	췑
cwenh	췒
cwed	췓
cwel	췔
cwelg	췕
cwelm	췖
cwelb	췗
cwels	췘
cwelt	췙
cwelp	췚
cwelh	췛
cwem	췜
cweb	췝
cwebs	췞
cwes	췟
cwess	췠
cweng	췡
cwej	췢
cwec	췣
cwek	췤
cwet	췥
cwep	췦
cweh	췧
cwi	취
cwig	췩
cwigg	췪
cwigs	췫
cwin	췬
cwinj	췭
cwinh	췮
cwid	췯
cwil	췰
cwilg	췱
cwilm	췲
cwilb	췳
cwils	췴
cwilt	췵
cwilp	췶
cwilh	췷
cwim	췸
cwib	췹
cwibs	췺
cwis	췻
cwiss	췼
cwing	췽
cwij	췾
cwic	췿
cwik	츀
cwit	츁
cwip	츂
cwih	츃
cyu	츄
cyug	츅
cyugg	츆
cyugs	츇
cyun	츈
cyunj	츉
cyunh	츊
cyud	츋
cyul	츌
cyulg	츍
cyulm	츎
cyulb	츏
cyuls	츐
cyult	츑
cyulp	츒
cyulh	츓
cyum	츔
cyub	츕
cyubs	츖
cyus	츗
cyuss	츘
cyung	츙
cyuj	츚
cyuc	츛
cyuk	츜
cyut	츝
cyup	츞
cyuh	츟
ceu	츠
ceug	측
ceugg	츢
ceugs	츣
ceun	츤
ceunj	츥
ceunh	츦
ceud	츧
ceul	츨
ceulg	츩
ceulm	츪
ceulb	츫
ceuls	츬
ceult	츭
ceulp	츮
ceulh	츯
ceum	츰
ceub	츱
ceubs	츲
ceus	츳
ceuss	츴
ceung	층
ceuj	츶
ceuc	츷
ceuk	츸
ceut	츹
ceup	츺
ceuh	츻
cyi	츼
cyig	츽
cyigg	츾
cyigs	츿
cyin	칀
cyinj	칁
cyinh	칂
cyid	칃
cyil	칄
cyilg	칅
cyilm	칆
cyilb	칇
cyils	칈
cyilt	칉
cyilp	칊
cyilh	칋
cyim	칌
cyib	칍
cyibs	칎
cyis	칏
cyiss	칐
cying	칑
cyij	칒
cyic	칓
cyik	칔
cyit	칕
cyip	칖
cyih	칗
ci	치
cig	칙
cigg	칚
cigs	칛
cin	친
cinj	칝
cinh	칞
cid	칟
cil	칠
cilg	칡
cilm	칢
cilb	칣
cils	칤
cilt	칥
cilp	칦
cilh	칧
cim	침
cib	칩
cibs	칪
cis	칫
ciss	칬
cing	칭
cij	칮
cic	칯
cik	칰
cit	칱
cip	칲
cih	칳
ka	카
kag	칵
kagg	칶
kags	칷
kan	칸
kanj	칹
kanh	칺
kad	칻
kal	칼
kalg	칽
kalm	칾
kalb	칿
kals	캀
kalt	캁
kalp	캂
kalh	캃
kam	캄
kab	캅
kabs	캆
kas	캇
kass	캈
kang	캉
kaj	캊
kac	캋
kak	캌
kat	캍
kap	캎
kah	캏
kae	캐
kaeg	캑
kaegg	캒
kaegs	캓
kaen	캔
kaenj	캕
kaenh	캖
kaed	캗
kael	캘
kaelg	캙
kaelm	캚
kaelb	캛
kaels	캜
kaelt	캝
kaelp	캞
kaelh	캟
kaem	캠
kaeb	캡
kaebs	캢
kaes	캣
kaess	캤
kaeng	캥
kaej	캦
kaec	캧
kaek	캨
kaet	캩
kaep	캪
kaeh	캫
kya	캬
kyag	캭
kyagg	캮
kyags	캯
kyan	캰
kyanj	캱
kyanh	캲
kyad	캳
kyal	캴
kyalg	캵
kyalm	캶
kyalb	캷
kyals	캸
kyalt	캹
kyalp	캺
kyalh	캻
kyam	캼
kyab	캽
kyabs	캾
kyas	캿
kyass	컀
kyang	컁
kyaj	컂
kyac	컃
kyak	컄
kyat	컅
kyap	컆
kyah	컇
kyae	컈
kyaeg	컉
kyaegg	컊
kyaegs	컋
kyaen	컌
kyaenj	컍
kyaenh	컎
kyaed	컏
kyael	컐
kyaelg	컑
kyaelm	컒
kyaelb	컓
kyaels	컔
kyaelt	컕
kyaelp	컖
kyaelh	컗
kyaem	컘
kyaeb	컙
kyaebs	컚
kyaes	컛
kyaess	컜
kyaeng	컝
kyaej	컞
kyaec	컟
kyaek	컠
kyaet	컡
kyaep	컢
kyaeh	컣
keo	커
keog	컥
keogg	컦
keogs	컧
keon	컨
keonj	컩
keonh	컪
keod	컫
keol	컬
keolg	컭
keolm	컮
keolb	컯
keols	컰
keolt	컱
keolp	컲
keolh	컳
keom	컴
keob	컵
keobs	컶
keos	컷
keoss	컸
keong	컹
keoj	컺
keoc	컻
keok	컼
keot	컽
keop	컾
keoh	컿
ke	케
keg	켁
kegg	켂
kegs	켃
ken	켄
kenj	켅
kenh	켆
ked	켇
kel	켈
kelg	켉
kelm	켊
kelb	켋
kels	켌
kelt	켍
kelp	켎
kelh	켏
kem	켐
keb	켑
kebs	켒
kes	켓
kess	켔
keng	켕
kej	켖
kec	켗
kek	켘
ket	켙
kep	켚
keh	켛
kyeo	켜
kyeog	켝
kyeogg	켞
kyeogs	켟
kyeon	켠
kyeonj	켡
kyeonh	켢
kyeod	켣
kyeol	켤
kyeolg	켥
kyeolm	켦
kyeolb	켧
kyeols	켨
kyeolt	켩
kyeolp	켪
kyeolh	켫
kyeom	켬
kyeob	켭
kyeobs	켮
kyeos	켯
kyeoss	켰
kyeong	켱
kyeoj	켲
kyeoc	켳
kyeok	켴
kyeot	켵
kyeop	켶
kyeoh	켷
kye	켸
kyeg	켹
kyegg	켺
kyegs	켻
kyen	켼
kyenj	켽
kyenh	켾
kyed	켿
kyel	콀
kyelg	콁
kyelm	콂
kyelb	콃
kyels	콄
kyelt	콅
kyelp	콆
kyelh	콇
kyem	콈
kyeb	콉
kyebs	콊
kyes	콋
kyess	콌
kyeng	콍
kyej	콎
kyec	콏
kyek	콐
kyet	콑
kyep	콒
kyeh	콓
ko	코
kog	콕
kogg	콖
kogs	콗
kon	콘
konj	콙
konh	콚
kod	콛
kol	콜
kolg	콝
kolm	콞
kolb	콟
kols	콠
kolt	콡
kolp	콢
kolh	콣
kom	콤
kob	콥
kobs	콦
kos	콧
koss	콨
kong	콩
koj	콪
koc	콫
kok	콬
kot	콭
kop	콮
koh	콯
kwa	콰
kwag	콱
kwagg	콲
kwags	콳
kwan	콴
kwanj	콵
kwanh	콶
kwad	콷
kwal	콸
kwalg	콹
kwalm	콺
kwalb	콻
kwals	콼
kwalt	콽
kwalp	콾
kwalh	콿
kwam	쾀
kwab	쾁
kwabs	쾂
kwas	쾃
kwass	쾄
kwang	쾅
kwaj	쾆
kwac	쾇
kwak	쾈
kwat	쾉
kwap	쾊
kwah	쾋
kwae	쾌
kwaeg	쾍
kwaegg	쾎
kwaegs	쾏
kwaen	쾐
kwaenj	쾑
kwaenh	쾒
kwaed	쾓
kwael	쾔
kwaelg	쾕
kwaelm	쾖
kwaelb	쾗
kwaels	쾘
kwaelt	쾙
kwaelp	쾚
kwaelh	쾛
kwaem	쾜
kwaeb	쾝
kwaebs	쾞
kwaes	쾟
kwaess	쾠
kwaeng	쾡
kwaej	쾢
kwaec	쾣
kwaek	쾤
kwaet	쾥
kwaep	쾦
kwaeh	쾧
koe	쾨
koeg	쾩
koegg	쾪
koegs	쾫
koen	쾬
koenj	쾭
koenh	쾮
koed	쾯
koel	쾰
koelg	쾱
koelm	쾲
koelb	쾳
koels	쾴
koelt	쾵
koelp	쾶
koelh	쾷
koem	쾸
koeb	쾹
koebs	쾺
koes	쾻
koess	쾼
koeng	쾽
koej	쾾
koec	쾿
koek	쿀
koet	쿁
koep	쿂
koeh	쿃
kyo	쿄
kyog	쿅
kyogg	쿆
kyogs	쿇
kyon	쿈
kyonj	쿉
kyonh	쿊
kyod	쿋
kyol	쿌
kyolg	쿍
kyolm	쿎
kyolb	쿏
kyols	쿐
kyolt	쿑
kyolp	쿒
kyolh	쿓
kyom	쿔
kyob	쿕
kyobs	쿖
kyos	쿗
kyoss	쿘
kyong	쿙
kyoj	쿚
kyoc	쿛
kyok	쿜
kyot	쿝
kyop	쿞
kyoh	쿟
ku	쿠
kug	쿡
kugg	쿢
kugs	쿣
kun	쿤
kunj	쿥
kunh	쿦
kud	쿧
kul	쿨
kulg	쿩
kulm	쿪
kulb	쿫
kuls	쿬
kult	쿭
kulp	쿮
kulh	쿯
kum	쿰
kub	쿱
kubs	쿲
kus	쿳
kuss	쿴
kung	쿵
kuj	쿶
kuc	쿷
kuk	쿸
kut	쿹
kup	쿺
kuh	쿻
kweo	쿼
kweog	쿽
kweogg	쿾
kweogs	쿿
kweon	퀀
kweonj	퀁
kweonh	퀂
kweod	퀃
kweol	퀄
kweolg	퀅
kweolm	퀆
kweolb	퀇
kweols	퀈
kweolt	퀉
kweolp	퀊
kweolh	퀋
kweom	퀌
kweob	퀍
kweobs	퀎
kweos	퀏
kweoss	퀐
kweong	퀑
kweoj	퀒
kweoc	퀓
kweok	퀔
kweot	퀕
kweop	퀖
kweoh	퀗
kwe	퀘
kweg	퀙
kwegg	퀚
kwegs	퀛
kwen	퀜
kwenj	퀝
kwenh	퀞
kwed	퀟
kwel	퀠
kwelg	퀡
kwelm	퀢
kwelb	퀣
kwels	퀤
kwelt	퀥
kwelp	퀦
kwelh	퀧
kwem	퀨
kweb	퀩
kwebs	퀪
kwes	퀫
kwess	퀬
kweng	퀭
kwej	퀮
kwec	퀯
kwek	퀰
kwet	퀱
kwep	퀲
kweh	퀳
kwi	퀴
kwig	퀵
kwigg	퀶
kwigs	퀷
kwin	퀸
kwinj	퀹
kwinh	퀺
kwid	퀻
kwil	퀼
kwilg	퀽
kwilm	퀾
kwilb	퀿
kwils	큀
kwilt	큁
kwilp	큂
kwilh	큃
kwim	큄
kwib	큅
kwibs	큆
kwis	큇
kwiss	큈
kwing	큉
kwij	큊
kwic	큋
kwik	큌
kwit	큍
kwip	큎
kwih	큏
kyu	큐
kyug	큑
kyugg	큒
kyugs	큓
kyun	큔
kyunj	큕
kyunh	큖
kyud	큗
kyul	큘
kyulg	큙
kyulm	큚
kyulb	큛
kyuls	큜
kyult	큝
kyulp	큞
kyulh	큟
kyum	큠
kyub	큡
kyubs	큢
kyus	큣
kyuss	큤
kyung	큥
kyuj	큦
kyuc	큧
kyuk	큨
kyut	큩
kyup	큪
kyuh	큫
keu	크
keug	큭
keugg	큮
keugs	큯
keun	큰
keunj	큱
keunh	큲
keud	큳
keul	클
keulg	큵
keulm	큶
keulb	큷
keuls	큸
keult	큹
keulp	큺
keulh	큻
keum	큼
keub	큽
keubs	큾
keus	큿
keuss	킀
keung	킁
keuj	킂
keuc	킃
keuk	킄
keut	킅
keup	킆
keuh	킇
kyi	킈
kyig	킉
kyigg	킊
kyigs	킋
kyin	킌
kyinj	킍
kyinh	킎
kyid	킏
kyil	킐
kyilg	킑
kyilm	킒
kyilb	킓
kyils	킔
kyilt	킕
kyilp	킖
kyilh	킗
kyim	킘
kyib	킙
kyibs	킚
kyis	킛
kyiss	킜
kying	킝
kyij	킞
kyic	킟
kyik	킠
kyit	킡
kyip	킢
kyih	킣
ki	키
kig	킥
kigg	킦
kigs	킧
kin	킨
kinj	킩
kinh	킪
kid	킫
kil	킬
kilg	킭
kilm	킮
kilb	킯
kils	킰
kilt	킱
kilp	킲
kilh	킳
kim	킴
kib	킵
kibs	킶
kis	킷
kiss	킸
king	킹
kij	킺
kic	킻
kik	킼
kit	킽
kip	킾
kih	킿
ta	타
tag	탁
tagg	탂
tags	탃
tan	탄
tanj	탅
tanh	탆
tad	탇
tal	탈
talg	탉
talm	탊
talb	탋
tals	탌
talt	탍
talp	탎
talh	탏
tam	탐
tab	탑
tabs	탒
tas	탓
tass	탔
tang	탕
taj	탖
tac	탗
tak	탘
tat	탙
tap	탚
tah	탛
tae	태
taeg	택
taegg	탞
taegs	탟
taen	탠
taenj	탡
taenh	탢
taed	탣
tael	탤
taelg	탥
taelm	탦
taelb	탧
taels	탨
taelt	탩
taelp	탪
taelh	탫
taem	탬
taeb	탭
taebs	탮
taes	탯
taess	탰
taeng	탱
taej	탲
taec	탳
taek	탴
taet	탵
taep	탶
taeh	탷
tya	탸
tyag	탹
tyagg	탺
tyags	탻
tyan	탼
tyanj	탽
tyanh	탾
tyad	탿
tyal	턀
tyalg	턁
tyalm	턂
tyalb	턃
tyals	턄
tyalt	턅
tyalp	턆
tyalh	턇
tyam	턈
tyab	턉
tyabs	턊
tyas	턋
tyass	턌
tyang	턍
tyaj	턎
tyac	턏
tyak	턐
tyat	턑
tyap	턒
tyah	턓
tyae	턔
tyaeg	턕
tyaegg	턖
tyaegs	턗
tyaen	턘
tyaenj	턙
tyaenh	턚
tyaed	턛
tyael	턜
tyaelg	턝
tyaelm	턞
tyaelb	턟
tyaels	턠
tyaelt	턡
tyaelp	턢
tyaelh	턣
tyaem	턤
tyaeb	턥
tyaebs	턦
tyaes	턧
tyaess	턨
tyaeng	턩
tyaej	턪
tyaec	턫
tyaek	턬
tyaet	턭
tyaep	턮
tyaeh	턯
teo	터
teog	턱
teogg	턲
teogs	턳
teon	턴
teonj	턵
teonh	턶
teod	턷
teol	털
teolg	턹
teolm	턺
teolb	턻
teols	턼
teolt	턽
teolp	턾
teolh	턿
teom	텀
teob	텁
teobs	텂
teos	텃
teoss	텄
teong	텅
teoj	텆
teoc	텇
teok	텈
teot	텉
teop	텊
teoh	텋
te	테
teg	텍
tegg	텎
tegs	텏
ten	텐
tenj	텑
tenh	텒
ted	텓
tel	텔
telg	텕
telm	텖
telb	텗
tels	텘
telt	텙
telp	텚
telh	텛
tem	템
teb	텝
tebs	텞
tes	텟
tess	텠
teng	텡
tej	텢
tec	텣
tek	텤
tet	텥
tep	텦
teh	텧
tyeo	텨
tyeog	텩
tyeogg	텪
tyeogs	텫
tyeon	텬
tyeonj	텭
tyeonh	텮
tyeod	텯
tyeol	텰
tyeolg	텱
tyeolm	텲
tyeolb	텳
tyeols	텴
tyeolt	텵
tyeolp	텶
tyeolh	텷
tyeom	텸
tyeob	텹
tyeobs	텺
tyeos	텻
tyeoss	텼
tyeong	텽
tyeoj	텾
tyeoc	텿
tyeok	톀
tyeot	톁
tyeop	톂
tyeoh	톃
tye	톄
tyeg	톅
tyegg	톆
tyegs	톇
tyen	톈
tyenj	톉
tyenh	톊
tyed	톋
tyel	톌
tyelg	톍
tyelm	톎
tyelb	톏
tyels	톐
tyelt	톑
tyelp	톒
tyelh	톓
tyem	톔
tyeb	톕
tyebs	톖
tyes	톗
tyess	톘
tyeng	톙
tyej	톚
tyec	톛
tyek	톜
tyet	톝
tyep	톞
tyeh	톟
to	토
tog	톡
togg	톢
togs	톣
ton	톤
tonj	톥
tonh	톦
tod	톧
tol	톨
tolg	톩
tolm	톪
tolb	톫
tols	톬
tolt	톭
tolp	톮
tolh	톯
tom	톰
tob	톱
tobs	톲
tos	톳
toss	톴
tong	통
toj	톶
toc	톷
tok	톸
tot	톹
top	톺
toh	톻
twa	톼
twag	톽
twagg	톾
twags	톿
twan	퇀
twanj	퇁
twanh	퇂
twad	퇃
twal	퇄
twalg	퇅
twalm	퇆
twalb	퇇
twals	퇈
twalt	퇉
twalp	퇊
twalh	퇋
twam	퇌
twab	퇍
twabs	퇎
twas	퇏
twass	퇐
twang	퇑
twaj	퇒
twac	퇓
twak	퇔
twat	퇕
twap	퇖
twah	퇗
twae	퇘
twaeg	퇙
twaegg	퇚
twaegs	퇛
twaen	퇜
twaenj	퇝
twaenh	퇞
twaed	퇟
twael	퇠
twaelg	퇡
twaelm	퇢
twaelb	퇣
twaels	퇤
twaelt	퇥
twaelp	퇦
twaelh	퇧
twaem	퇨
twaeb	퇩
twaebs	퇪
twaes	퇫
twaess	퇬
twaeng	퇭
twaej	퇮
twaec	퇯
twaek	퇰
twaet	퇱
twaep	퇲
twaeh	퇳
toe	퇴
toeg	퇵
toegg	퇶
toegs	퇷
toen	퇸
toenj	퇹
toenh	퇺
toed	퇻
toel	퇼
toelg	퇽
toelm	퇾
toelb	퇿
toels	툀
toelt	툁
toelp	툂
toelh	툃
toem	툄
toeb	툅
toebs	툆
toes	툇
toess	툈
toeng	툉
toej	툊
toec	툋
toek	툌
toet	툍
toep	툎
toeh	툏
tyo	툐
tyog	툑
tyogg	툒
tyogs	툓
tyon	툔
tyonj	툕
tyonh	툖
tyod	툗
tyol	툘
tyolg	툙
tyolm	툚
tyolb	툛
tyols	툜
tyolt	툝
tyolp	툞
tyolh	툟
tyom	툠
tyob	툡
tyobs	툢
tyos	툣
tyoss	툤
tyong	툥
tyoj	툦
tyoc	툧
tyok	툨
tyot	툩
tyop	툪
tyoh	툫
tu	투
tug	툭
tugg	툮
tugs	툯
tun	툰
tunj	툱
tunh	툲
tud	툳
tul	툴
tulg	툵
tulm	툶
tulb	툷
tuls	툸
tult	툹
tulp	툺
tulh	툻
tum	툼
tub	툽
tubs	툾
tus	툿
tuss	퉀
tung	퉁
tuj	퉂
tuc	퉃
tuk	퉄
tut	퉅
tup	퉆
tuh	퉇
tweo	퉈
tweog	퉉
tweogg	퉊
tweogs	퉋
tweon	퉌
tweonj	퉍
tweonh	퉎
tweod	퉏
tweol	퉐
tweolg	퉑
tweolm	퉒
tweolb	퉓
tweols	퉔
tweolt	퉕
tweolp	퉖
tweolh	퉗
tweom	퉘
tweob	퉙
tweobs	퉚
tweos	퉛
tweoss	퉜
tweong	퉝
tweoj	퉞
tweoc	퉟
tweok	퉠
tweot	퉡
tweop	퉢
tweoh	퉣
twe	퉤
tweg	퉥
twegg	퉦
twegs	퉧
twen	퉨
twenj	퉩
twenh	퉪
twed	퉫
twel	퉬
twelg	퉭
twelm	퉮
twelb	퉯
twels	퉰
twelt	퉱
twelp	퉲
twelh	퉳
twem	퉴
tweb	퉵
twebs	퉶
twes	퉷
twess	퉸
tweng	퉹
twej	퉺
twec	퉻
twek	퉼
twet	퉽
twep	퉾
tweh	퉿
twi	튀
twig	튁
twigg	튂
twigs	튃
twin	튄
twinj	튅
twinh	튆
twid	튇
twil	튈
twilg	튉
twilm	튊
twilb	튋
twils	튌
twilt	튍
twilp	튎
twilh	튏
twim	튐
twib	튑
twibs	튒
twis	튓
twiss	튔
twing	튕
twij	튖
twic	튗
twik	튘
twit	튙
twip	튚
twih	튛
tyu	튜
tyug	튝
tyugg	튞
tyugs	튟
tyun	튠
tyunj	튡
tyunh	튢
tyud	튣
tyul	튤
tyulg	튥
tyulm	튦
tyulb	튧
tyuls	튨
tyult	튩
tyulp	튪
tyulh	튫
tyum	튬
tyub	튭
tyubs	튮
tyus	튯
tyuss	튰
tyung	튱
tyuj	튲
tyuc	튳
tyuk	튴
tyut	튵
tyup	튶
tyuh	튷
teu	트
teug	특
teugg	튺
teugs	튻
teun	튼
teunj	튽
teunh	튾
teud	튿
teul	틀
teulg	틁
teulm	틂
teulb	틃
teuls	틄
teult	틅
teulp	틆
teulh	틇
teum	틈
teub	틉
teubs	틊
teus	틋
teuss	틌
teung	틍
teuj	틎
teuc	틏
teuk	틐
teut	틑
teup	틒
teuh	틓
tyi	틔
tyig	틕
tyigg	틖
tyigs	틗
tyin	틘
tyinj	틙
tyinh	틚
tyid	틛
tyil	틜
tyilg	틝
tyilm	틞
tyilb	틟
tyils	틠
tyilt	틡
tyilp	틢
tyilh	틣
tyim	틤
tyib	틥
tyibs	틦
tyis	틧
tyiss	틨
tying	틩
tyij	틪
tyic	틫
tyik	틬
tyit	틭
tyip	틮
tyih	틯
ti	티
tig	틱
tigg	틲
tigs	틳
tin	틴
tinj	틵
tinh	틶
tid	틷
til	틸
tilg	틹
tilm	틺
tilb	틻
tils	틼
tilt	틽
tilp	틾
tilh	틿
tim	팀
tib	팁
tibs	팂
tis	팃
tiss	팄
ting	팅
tij	팆
tic	팇
tik	팈
tit	팉
tip	팊
tih	팋
pa	파
pag	팍
pagg	팎
pags	팏
pan	판
panj	팑
panh	팒
pad	팓
pal	팔
palg	팕
palm	팖
palb	팗
pals	팘
palt	팙
palp	팚
palh	팛
pam	팜
pab	팝
pabs	팞
pas	팟
pass	팠
pang	팡
paj	팢
pac	팣
pak	팤
pat	팥
pap	팦
pah	팧
pae	패
paeg	팩
paegg	팪
paegs	팫
paen	팬
paenj	팭
paenh	팮
paed	팯
pael	팰
paelg	팱
paelm	팲
paelb	팳
paels	팴
paelt	팵
paelp	팶
paelh	팷
paem	팸
paeb	팹
paebs	팺
paes	팻
paess	팼
paeng	팽
paej	팾
paec	팿
paek	퍀
paet	퍁
paep	퍂
paeh	퍃
pya	퍄
pyag	퍅
pyagg	퍆
pyags	퍇
pyan	퍈
pyanj	퍉
pyanh	퍊
pyad	퍋
pyal	퍌
pyalg	퍍
pyalm	퍎
pyalb	퍏
pyals	퍐
pyalt	퍑
pyalp	퍒
pyalh	퍓
pyam	퍔
pyab	퍕
pyabs	퍖
pyas	퍗
pyass	퍘
pyang	퍙
pyaj	퍚
pyac	퍛
pyak	퍜
pyat	퍝
pyap	퍞
pyah	퍟
pyae	퍠
pyaeg	퍡
pyaegg	퍢
pyaegs	퍣
pyaen	퍤
pyaenj	퍥
pyaenh	퍦
pyaed	퍧
pyael	퍨
pyaelg	퍩
pyaelm	퍪
pyaelb	퍫
pyaels	퍬
pyaelt	퍭
pyaelp	퍮
pyaelh	퍯
pyaem	퍰
pyaeb	퍱
pyaebs	퍲
pyaes	퍳
pyaess	퍴
pyaeng	퍵
pyaej	퍶
pyaec	퍷
pyaek	퍸
pyaet	퍹
pyaep	퍺
pyaeh	퍻
peo	퍼
peog	퍽
peogg	퍾
peogs	퍿
peon	펀
peonj	펁
peonh	펂
peod	펃
peol	펄
peolg	펅
peolm	펆
peolb	펇
peols	펈
peolt	펉
peolp	펊
peolh	펋
peom	펌
peob	펍
peobs	펎
peos	펏
peoss	펐
peong	펑
peoj	펒
peoc	펓
peok	펔
peot	펕
peop	펖
peoh	펗
pe	페
peg	펙
pegg	펚
pegs	펛
pen	펜
penj	펝
penh	펞
ped	펟
pel	펠
pelg	펡
pelm	펢
pelb	펣
pels	펤
pelt	펥
pelp	펦
pelh	펧
pem	펨
peb	펩
pebs	펪
pes	펫
pess	펬
peng	펭
pej	펮
pec	펯
pek	펰
pet	펱
pep	펲
peh	펳
pyeo	펴
pyeog	펵
pyeogg	펶
pyeogs	펷
pyeon	편
pyeonj	펹
pyeonh	펺
pyeod	펻
pyeol	펼
pyeolg	펽
pyeolm	펾
pyeolb	펿
pyeols	폀
pyeolt	폁
pyeolp	폂
pyeolh	폃
pyeom	폄
pyeob	폅
pyeobs	폆
pyeos	폇
pyeoss	폈
pyeong	평
pyeoj	폊
pyeoc	폋
pyeok	폌
pyeot	폍
pyeop	폎
pyeoh	폏
pye	폐
pyeg	폑
pyegg	폒
pyegs	폓
pyen	폔
pyenj	폕
pyenh	폖
pyed	폗
pyel	폘
pyelg	폙
pyelm	폚
pyelb	폛
pyels	폜
pyelt	폝
pyelp	폞
pyelh	폟
pyem	폠
pyeb	폡
pyebs	폢
pyes	폣
pyess	폤
pyeng	폥
pyej	폦
pyec	폧
pyek	폨
pyet	폩
pyep	폪
pyeh	폫
po	포
pog	폭
pogg	폮
pogs	폯
pon	폰
ponj	폱
ponh	폲
pod	폳
pol	폴
polg	폵
polm	폶
polb	폷
pols	폸
polt	폹
polp	폺
polh	폻
pom	폼
pob	폽
pobs	폾
pos	폿
poss	퐀
pong	퐁
poj	퐂
poc	퐃
pok	퐄
pot	퐅
pop	퐆
poh	퐇
pwa	퐈
pwag	퐉
pwagg	퐊
pwags	퐋
pwan	퐌
pwanj	퐍
pwanh	퐎
pwad	퐏
pwal	퐐
pwalg	퐑
pwalm	퐒
pwalb	퐓
pwals	퐔
pwalt	퐕
pwalp	퐖
pwalh	퐗
pwam	퐘
pwab	퐙
pwabs	퐚
pwas	퐛
pwass	퐜
pwang	퐝
pwaj	퐞
pwac	퐟
pwak	퐠
pwat	퐡
pwap	퐢
pwah	퐣
pwae	퐤
pwaeg	퐥
pwaegg	퐦
pwaegs	퐧
pwaen	퐨
pwaenj	퐩
pwaenh	퐪
pwaed	퐫
pwael	퐬
pwaelg	퐭
pwaelm	퐮
pwaelb	퐯
pwaels	퐰
pwaelt	퐱
pwaelp	퐲
pwaelh	퐳
pwaem	퐴
pwaeb	퐵
pwaebs	퐶
pwaes	퐷
pwaess	퐸
pwaeng	퐹
pwaej	퐺
pwaec	퐻
pwaek	퐼
pwaet	퐽
pwaep	퐾
pwaeh	퐿
poe	푀
poeg	푁
poegg	푂
poegs	푃
poen	푄
poenj	푅
poenh	푆
poed	푇
poel	푈
poelg	푉
poelm	푊
poelb	푋
poels	푌
poelt	푍
poelp	푎
poelh	푏
poem	푐
poeb	푑
poebs	푒
poes	푓
poess	푔
poeng	푕
poej	푖
poec	푗
poek	푘
poet	푙
poep	푚
poeh	푛
pyo	표
pyog	푝
pyogg	푞
pyogs	푟
pyon	푠
pyonj	푡
pyonh	푢
pyod	푣
pyol	푤
pyolg	푥
pyolm	푦
pyolb	푧
pyols	푨
pyolt	푩
pyolp	푪
pyolh	푫
pyom	푬
pyob	푭
pyobs	푮
pyos	푯
pyoss	푰
pyong	푱
pyoj	푲
pyoc	푳
pyok	푴
pyot	푵
pyop	푶
pyoh	푷
pu	푸
pug	푹
pugg	푺
pugs	푻
pun	푼
punj	푽
punh	푾
pud	푿
pul	풀
pulg	풁
pulm	풂
pulb	풃
puls	풄
pult	풅
pulp	풆
pulh	풇
pum	품
pub	풉
pubs	풊
pus	풋
puss	풌
pung	풍
puj	풎
puc	풏
puk	풐
put	풑
pup	풒
puh	풓
pweo	풔
pweog	풕
pweogg	풖
pweogs	풗
pweon	풘
pweonj	풙
pweonh	풚
pweod	풛
pweol	풜
pweolg	풝
pweolm	풞
pweolb	풟
pweols	풠
pweolt	풡
pweolp	풢
pweolh	풣
pweom	풤
pweob	풥
pweobs	풦
pweos	풧
pweoss	풨
pweong	풩
pweoj	풪
pweoc	풫
pweok	풬
pweot	풭
pweop	풮
pweoh	풯
pwe	풰
pweg	풱
pwegg	풲
pwegs	풳
pwen	풴
pwenj	풵
pwenh	풶
pwed	풷
pwel	풸
pwelg	풹
pwelm	풺
pwelb	풻
pwels	풼
pwelt	풽
pwelp	풾
pwelh	풿
pwem	퓀
pweb	퓁
pwebs	퓂
pwes	퓃
pwess	퓄
pweng	퓅
pwej	퓆
pwec	퓇
pwek	퓈
pwet	퓉
pwep	퓊
pweh	퓋
pwi	퓌
pwig	퓍
pwigg	퓎
pwigs	퓏
pwin	퓐
pwinj	퓑
pwinh	퓒
pwid	퓓
pwil	퓔
pwilg	퓕
pwilm	퓖
pwilb	퓗
pwils	퓘
pwilt	퓙
pwilp	퓚
pwilh	퓛
pwim	퓜
pwib	퓝
pwibs	퓞
pwis	퓟
pwiss	퓠
pwing	퓡
pwij	퓢
pwic	퓣
pwik	퓤
pwit	퓥
pwip	퓦
pwih	퓧
pyu	퓨
pyug	퓩
pyugg	퓪
pyugs	퓫
pyun	퓬
pyunj	퓭
pyunh	퓮
pyud	퓯
pyul	퓰
pyulg	퓱
pyulm	퓲
pyulb	퓳
pyuls	퓴
pyult	퓵
pyulp	퓶
pyulh	퓷
pyum	퓸
pyub	퓹
pyubs	퓺
pyus	퓻
pyuss	퓼
pyung	퓽
pyuj	퓾
pyuc	퓿
pyuk	픀
pyut	픁
pyup	픂
pyuh	픃
peu	프
peug	픅
peugg	픆
peugs	픇
peun	픈
peunj	픉
peunh	픊
peud	픋
peul	플
peulg	픍
peulm	픎
peulb	픏
peuls	픐
peult	픑
peulp	픒
peulh	픓
peum	픔
peub	픕
peubs	픖
peus	픗
peuss	픘
peung	픙
peuj	픚
peuc	픛
peuk	픜
peut	픝
peup	픞
peuh	픟
pyi	픠
pyig	픡
pyigg	픢
pyigs	픣
pyin	픤
pyinj	픥
pyinh	픦
pyid	픧
pyil	픨
pyilg	픩
pyilm	픪
pyilb	픫
pyils	픬
pyilt	픭
pyilp	픮
pyilh	픯
pyim	픰
pyib	픱
pyibs	픲
pyis	픳
pyiss	픴
pying	픵
pyij	픶
pyic	픷
pyik	픸
pyit	픹
pyip	픺
pyih	픻
pi	피
pig	픽
pigg	픾
pigs	픿
pin	핀
pinj	핁
pinh	핂
pid	핃
pil	필
pilg	핅
pilm	핆
pilb	핇
pils	핈
pilt	핉
pilp	핊
pilh	핋
pim	핌
pib	핍
pibs	핎
pis	핏
piss	핐
ping	핑
pij	핒
pic	핓
pik	핔
pit	핕
pip	핖
pih	핗
ha	하
hag	학
hagg	핚
hags	핛
han	한
hanj	핝
hanh	핞
had	핟
hal	할
halg	핡
halm	핢
halb	핣
hals	핤
halt	핥
halp	핦
halh	핧
ham	함
hab	합
habs	핪
has	핫
hass	핬
hang	항
haj	핮
hac	핯
hak	핰
hat	핱
hap	핲
hah	핳
hae	해
haeg	핵
haegg	핶
haegs	핷
haen	핸
haenj	핹
haenh	핺
haed	핻
hael	핼
haelg	핽
haelm	핾
haelb	핿
haels	햀
haelt	햁
haelp	햂
haelh	햃
haem	햄
haeb	햅
haebs	햆
haes	햇
haess	했
haeng	행
haej	햊
haec	햋
haek	햌
haet	햍
haep	햎
haeh	햏
hya	햐
hyag	햑
hyagg	햒
hyags	햓
hyan	햔
hyanj	햕
hyanh	햖
hyad	햗
hyal	햘
hyalg	햙
hyalm	햚
hyalb	햛
hyals	햜
hyalt	햝
hyalp	햞
hyalh	햟
hyam	햠
hyab	햡
hyabs	햢
hyas	햣
hyass	햤
hyang	향
hyaj	햦
hyac	햧
hyak	햨
hyat	햩
hyap	햪
hyah	햫
hyae	햬
hyaeg	햭
hyaegg	햮
hyaegs	햯
hyaen	햰
hyaenj	햱
hyaenh	햲
hyaed	햳
hyael	햴
hyaelg	햵
hyaelm	햶
hyaelb	햷
hyaels	햸
hyaelt	햹
hyaelp	햺
hyaelh	햻
hyaem	햼
hyaeb	햽
hyaebs	햾
hyaes	햿
hyaess	헀
hyaeng	헁
hyaej	헂
hyaec	헃
hyaek	헄
hyaet	헅
hyaep	헆
hyaeh	헇
heo	허
heog	헉
heogg	헊
heogs	헋
heon	헌
heonj	헍
heonh	헎
heod	헏
heol	헐
heolg	헑
heolm	헒
heolb	헓
heols	헔
heolt	헕
heolp	헖
heolh	헗
heom	험
heob	헙
heobs	헚
heos	헛
heoss	헜
heong	헝
heoj	헞
heoc	헟
heok	헠
heot	헡
heop	헢
heoh	헣
he	헤
heg	헥
hegg	헦
hegs	헧
hen	헨
henj	헩
henh	헪
hed	헫
hel	헬
helg	헭
helm	헮
helb	헯
hels	헰
helt	헱
help	헲
helh	헳
hem	헴
heb	헵
hebs	헶
hes	헷
hess	헸
heng	헹
hej	헺
hec	헻
hek	헼
het	헽
hep	헾
heh	헿
hyeo	혀
hyeog	혁
hyeogg	혂
hyeogs	혃
hyeon	현
hyeonj	혅
hyeonh	혆
hyeod	혇
hyeol	혈
hyeolg	혉
hyeolm	혊
hyeolb	혋
hyeols	혌
hyeolt	혍
hyeolp	혎
hyeolh	혏
hyeom	혐
hyeob	협
hyeobs	혒
hyeos	혓
hyeoss	혔
hyeong	형
hyeoj	혖
hyeoc	혗
hyeok	혘
hyeot	혙
hyeop	혚
hyeoh	혛
hye	혜
hyeg	혝
hyegg	혞
hyegs	혟
hyen	혠
hyenj	혡
hyenh	혢
hyed	혣
hyel	혤
hyelg	혥
hyelm	혦
hyelb	혧
hyels	혨
hyelt	혩
hyelp	혪
hyelh	혫
hyem	혬
hyeb	혭
hyebs	혮
hyes	혯
hyess	혰
hyeng	혱
hyej	혲
hyec	혳
hyek	혴
hyet	혵
hyep	혶
hyeh	혷
ho	호
hog	혹
hogg	혺
hogs	혻
hon	혼
honj	혽
honh	혾
hod	혿
hol	홀
holg	홁
holm	홂
holb	홃
hols	홄
holt	홅
holp	홆
holh	홇
hom	홈
hob	홉
hobs	홊
hos	홋
hoss	홌
hong	홍
hoj	홎
hoc	홏
hok	홐
hot	홑
hop	홒
hoh	홓
hwa	화
hwag	확
hwagg	홖
hwags	홗
hwan	환
hwanj	홙
hwanh	홚
hwad	홛
hwal	활
hwalg	홝
hwalm	홞
hwalb	홟
hwals	홠
hwalt	홡
hwalp	홢
hwalh	홣
hwam	홤
hwab	홥
hwabs	홦
hwas	홧
hwass	홨
hwang	황
hwaj	홪
hwac	홫
hwak	홬
hwat	홭
hwap	홮
hwah	홯
hwae	홰
hwaeg	홱
hwaegg	홲
hwaegs	홳
hwaen	홴
hwaenj	홵
hwaenh	홶
hwaed	홷
hwael	홸
hwaelg	홹
hwaelm	홺
hwaelb	홻
hwaels	홼
hwaelt	홽
hwaelp	홾
hwaelh	홿
hwaem	횀
hwaeb	횁
hwaebs	횂
hwaes	횃
hwaess	횄
hwaeng	횅
hwaej	횆
hwaec	횇
hwaek	횈
hwaet	횉
hwaep	횊
hwaeh	횋
hoe	회
hoeg	획
hoegg	횎
hoegs	횏
hoen	횐
hoenj	횑
hoenh	횒
hoed	횓
hoel	횔
hoelg	횕
hoelm	횖
hoelb	횗
hoels	횘
hoelt	횙
hoelp	횚
hoelh	횛
hoem	횜
hoeb	횝
hoebs	횞
hoes	횟
hoess	횠
hoeng	횡
hoej	횢
hoec	횣
hoek	횤
hoet	횥
hoep	횦
hoeh	횧
hyo	효
hyog	횩
hyogg	횪
hyogs	횫
hyon	횬
hyonj	횭
hyonh	횮
hyod	횯
hyol	횰
hyolg	횱
hyolm	횲
hyolb	횳
hyols	횴
hyolt	횵
hyolp	횶
hyolh	횷
hyom	횸
hyob	횹
hyobs	횺
hyos	횻
hyoss	횼
hyong	횽
hyoj	횾
hyoc	횿
hyok	훀
hyot	훁
hyop	훂
hyoh	훃
hu	후
hug	훅
hugg	훆
hugs	훇
hun	훈
hunj	훉
hunh	훊
hud	훋
hul	훌
hulg	훍
hulm	훎
hulb	훏
huls	훐
hult	훑
hulp	훒
hulh	훓
hum	훔
hub	훕
hubs	훖
hus	훗
huss	훘
hung	훙
huj	훚
huc	훛
huk	훜
hut	훝
hup	훞
huh	훟
hweo	훠
hweog	훡
hweogg	훢
hweogs	훣
hweon	훤
hweonj	훥
hweonh	훦
hweod	훧
hweol	훨
hweolg	훩
hweolm	훪
hweolb	훫
hweols	훬
hweolt	훭
hweolp	훮
hweolh	훯
hweom	훰
hweob	훱
hweobs	훲
hweos	훳
hweoss	훴
hweong	훵
hweoj	훶
hweoc	훷
hweok	훸
hweot	훹
hweop	훺
hweoh	훻
hwe	훼
hweg	훽
hwegg	훾
hwegs	훿
hwen	휀
hwenj	휁
hwenh	휂
hwed	휃
hwel	휄
hwelg	휅
hwelm	휆
hwelb	휇
hwels	휈
hwelt	휉
hwelp	휊
hwelh	휋
hwem	휌
hweb	휍
hwebs	휎
hwes	휏
hwess	휐
hweng	휑
hwej	휒
hwec	휓
hwek	휔
hwet	휕
hwep	휖
hweh	휗
hwi	휘
hwig	휙
hwigg	휚
hwigs	휛
hwin	휜
hwinj	휝
hwinh	휞
hwid	휟
hwil	휠
hwilg	휡
hwilm	휢
hwilb	휣
hwils	휤
hwilt	휥
hwilp	휦
hwilh	휧
hwim	휨
hwib	휩
hwibs	휪
hwis	휫
hwiss	휬
hwing	휭
hwij	휮
hwic	휯
hwik	휰
hwit	휱
hwip	휲
hwih	휳
hyu	휴
hyug	휵
hyugg	휶
hyugs	휷
hyun	휸
hyunj	휹
hyunh	휺
hyud	휻
hyul	휼
hyulg	휽
hyulm	휾
hyulb	휿
hyuls	흀
hyult	흁
hyulp	흂
hyulh	흃
hyum	흄
hyub	흅
hyubs	흆
hyus	흇
hyuss	흈
hyung	흉
hyuj	흊
hyuc	흋
hyuk	흌
hyut	흍
hyup	흎
hyuh	흏
heu	흐
heug	흑
heugg	흒
heugs	흓
heun	흔
heunj	흕
heunh	흖
heud	흗
heul	흘
heulg	흙
heulm	흚
heulb	흛
heuls	흜
heult	흝
heulp	흞
heulh	흟
heum	흠
heub	흡
heubs	흢
heus	흣
heuss	흤
heung	흥
heuj	흦
heuc	흧
heuk	흨
heut	흩
heup	흪
heuh	흫
hyi	희
hyig	흭
hyigg	흮
hyigs	흯
hyin	흰
hyinj	흱
hyinh	흲
hyid	흳
hyil	흴
hyilg	흵
hyilm	흶
hyilb	흷
hyils	흸
hyilt	흹
hyilp	흺
hyilh	흻
hyim	흼
hyib	흽
hyibs	흾
hyis	흿
hyiss	힀
hying	힁
hyij	힂
hyic	힃
hyik	힄
hyit	힅
hyip	힆
hyih	힇
hi	히
hig	힉
higg	힊
higs	힋
hin	힌
hinj	힍
hinh	힎
hid	힏
hil	힐
hilg	힑
hilm	힒
hilb	힓
hils	힔
hilt	힕
hilp	힖
hilh	힗
him	힘
hib	힙
hibs	힚
his	힛
hiss	힜
hing	힝
hij	힞
hic	힟
hik	힠
hit	힡
hip	힢
hih	힣
